roll_no,sub_code,internal_marks,external_marks,sgpa,total_marks
1783930001,RAS101,21,43,7.67,64
1783930001,RAS102,24,37,7.67,61
1783930001,RAS103,24,69,7.67,93
1783930001,RME101,26,41,7.67,67
1783930001,RCS101,23,23,7.67,46
1783930001,RAS152,46,42,7.67,88
1783930001,RME151,46,43,7.67,89
1783930001,RCS151,42,40,7.67,82
1783930001,RCE151,44,41,7.67,85
1783930001,RAS203,29,63,7.79,92
1783930001,RAS201,24,48,7.79,72
1783930001,REE201,29,28,7.79,57
1783930001,RAS204,19,44,7.79,63
1783930001,REC201,24,33,7.79,57
1783930001,RAS251,48,45,7.79,93
1783930001,REE251,48,45,7.79,93
1783930001,RAS254,40,38,7.79,78
1783930001,RME252,46,40,7.79,86
1783930001,RAS301,26,60,7.25,86
1783930001,RVE301,16,27,7.25,43
1783930001,REE305,27,45,7.25,72
1783930001,REC301,22,40,7.25,62
1783930001,REC302,23,39,7.25,62
1783930001,REC303,27,32,7.25,59
1783930001,REC351,44,44,7.25,88
1783930001,REC352,40,36,7.25,76
1783930001,REC353,39,48,7.25,87
1783930001,REC354,41,44,7.25,85
1783930001,ROE047,22,41,7.21,63
1783930001,RAS402,20,43,7.21,63
1783930001,REC401,20,38,7.21,58
1783930001,REC402,24,50,7.21,74
1783930001,REC403,22,37,7.21,59
1783930001,RCS406,22,44,7.21,66
1783930001,REC451,40,35,7.21,75
1783930001,REC452,42,44,7.21,86
1783930001,REC453,42,46,7.21,88
1783930001,RCS456,44,41,7.21,85
1783930001,RAS501,25,43,7.71,68
1783930001,RAS502,23,36,7.71,59
1783930001,REC501A,26,38,7.71,64
1783930001,REC502,26,51,7.71,77
1783930001,REC503,26,49,7.71,75
1783930001,REC051,24,51,7.71,75
1783930001,REC551,46,38,7.71,84
1783930001,REC552,42,45,7.71,87
1783930001,REC553,47,46,7.71,93
1783930001,REC554,45,42,7.71,87
1783930001,RAS601,28,50,7.67,78
1783930001,RUC601,23,46,7.67,69
1783930001,RIC603,20,44,7.67,64
1783930001,REC601,25,48,7.67,73
1783930001,REC602,22,45,7.67,67
1783930001,REC064,19,43,7.67,62
1783930001,REC651,45,44,7.67,89
1783930001,REC652,43,43,7.67,86
1783930001,RIC653,42,43,7.67,85
1783930001,RIC651,48,44,7.67,92
1783930001,ROE072,22,41,7.54,63
1783930001,REC072,24,43,7.54,67
1783930001,REC075,24,38,7.54,62
1783930001,REC701,28,36,7.54,64
1783930001,REC702,24,48,7.54,72
1783930001,REC751,44,46,7.54,90
1783930001,REC752,36,46,7.54,82
1783930001,REC753,76,0,7.54,76
1783930001,REC754,155,0,7.54,155
1783930002,RAS101,19,35,6.75,54
1783930002,RAS102,19,21,6.75,40
1783930002,RAS103,20,51,6.75,71
1783930002,RME101,20,38,6.75,58
1783930002,RCS101,30,39,6.75,69
1783930002,RAS152,40,38,6.75,78
1783930002,RME151,40,43,6.75,83
1783930002,RCS151,50,46,6.75,96
1783930002,RCE151,45,39,6.75,84
1783930002,RAS203,12,33,6.79,45
1783930002,RAS201,15,50,6.79,65
1783930002,REE201,19,35,6.79,54
1783930002,RAS204,21,56,6.79,77
1783930002,REC201,16,38,6.79,54
1783930002,RAS251,42,42,6.79,84
1783930002,REE251,38,48,6.79,86
1783930002,RAS254,45,38,6.79,83
1783930002,RME252,37,42,6.79,79
1783930002,RAS301,17,48,6.92,65
1783930002,RVE301,21,41,6.92,62
1783930002,REE305,21,47,6.92,68
1783930002,REC301,23,45,6.92,68
1783930002,REC302,18,43,6.92,61
1783930002,REC303,17,32,6.92,49
1783930002,REC351,36,40,6.92,76
1783930002,REC352,36,34,6.92,70
1783930002,REC353,39,39,6.92,78
1783930002,REC354,39,35,6.92,74
1783930002,ROE047,24,46,7.21,70
1783930002,RAS402,22,41,7.21,63
1783930002,REC401,15,47,7.21,62
1783930002,REC402,11,46,7.21,57
1783930002,REC403,15,41,7.21,56
1783930002,RCS406,16,44,7.21,60
1783930002,REC451,44,40,7.21,84
1783930002,REC452,38,41,7.21,79
1783930002,REC453,40,44,7.21,84
1783930002,RCS456,44,48,7.21,92
1783930002,RAS501,25,48,7.13,73
1783930002,RAS502,25,55,7.13,80
1783930002,REC501A,17,39,7.13,56
1783930002,REC502,16,34,7.13,50
1783930002,REC503,11,38,7.13,49
1783930002,REC051,12,55,7.13,67
1783930002,REC551,41,38,7.13,79
1783930002,REC552,42,41,7.13,83
1783930002,REC553,43,40,7.13,83
1783930002,REC554,40,42,7.13,82
1783930002,RAS601,28,50,7.5,78
1783930002,RUC601,28,50,7.5,78
1783930002,RIC603,17,42,7.5,59
1783930002,REC601,19,43,7.5,62
1783930002,REC602,25,48,7.5,73
1783930002,REC064,18,43,7.5,61
1783930002,REC651,43,42,7.5,85
1783930002,REC652,42,42,7.5,84
1783930002,RIC653,40,41,7.5,81
1783930002,RIC651,30,38,7.5,68
1783930002,ROE072,25,44,7.79,69
1783930002,REC072,27,40,7.79,67
1783930002,REC075,25,51,7.79,76
1783930002,REC701,22,34,7.79,56
1783930002,REC702,25,53,7.79,78
1783930002,REC751,47,50,7.79,97
1783930002,REC752,41,50,7.79,91
1783930002,REC753,82,0,7.79,82
1783930002,REC754,175,0,7.79,175
1783930003,RAS101,18,49,7.63,67
1783930003,RAS102,27,31,7.63,58
1783930003,RAS103,23,48,7.63,71
1783930003,RME101,21,48,7.63,69
1783930003,RCS101,29,43,7.63,72
1783930003,RAS152,48,47,7.63,95
1783930003,RME151,41,46,7.63,87
1783930003,RCS151,49,42,7.63,91
1783930003,RCE151,44,39,7.63,83
1783930003,RAS203,15,34,7.29,49
1783930003,RAS201,15,48,7.29,63
1783930003,REE201,27,40,7.29,67
1783930003,RAS204,27,36,7.29,63
1783930003,REC201,21,45,7.29,66
1783930003,RAS251,44,48,7.29,92
1783930003,REE251,47,49,7.29,96
1783930003,RAS254,45,45,7.29,90
1783930003,RME252,49,41,7.29,90
1783930003,RAS301,20,56,7.25,76
1783930003,RVE301,21,25,7.25,46
1783930003,REE305,28,39,7.25,67
1783930003,REC301,21,48,7.25,69
1783930003,REC302,23,37,7.25,60
1783930003,REC303,21,39,7.25,60
1783930003,REC351,40,41,7.25,81
1783930003,REC352,40,46,7.25,86
1783930003,REC353,39,42,7.25,81
1783930003,REC354,45,44,7.25,89
1783930003,ROE047,26,47,8.0,73
1783930003,RAS402,22,49,8.0,71
1783930003,REC401,26,48,8.0,74
1783930003,REC402,17,44,8.0,61
1783930003,REC403,24,49,8.0,73
1783930003,RCS406,26,41,8.0,67
1783930003,REC451,45,46,8.0,91
1783930003,REC452,48,49,8.0,97
1783930003,REC453,49,44,8.0,93
1783930003,RCS456,47,41,8.0,88
1783930003,RAS501,27,40,7.38,67
1783930003,RAS502,26,45,7.38,71
1783930003,REC501A,21,45,7.38,66
1783930003,REC502,23,40,7.38,63
1783930003,REC503,17,56,7.38,73
1783930003,REC051,17,41,7.38,58
1783930003,REC551,44,42,7.38,86
1783930003,REC552,37,40,7.38,77
1783930003,REC553,41,40,7.38,81
1783930003,REC554,43,45,7.38,88
1783930003,RAS601,28,51,7.92,79
1783930003,RUC601,25,49,7.92,74
1783930003,RIC603,21,46,7.92,67
1783930003,REC601,25,49,7.92,74
1783930003,REC602,26,49,7.92,75
1783930003,REC064,18,44,7.92,62
1783930003,REC651,44,44,7.92,88
1783930003,REC652,43,44,7.92,87
1783930003,RIC653,42,44,7.92,86
1783930003,RIC651,45,45,7.92,90
1783930003,ROE072,23,35,8.46,58
1783930003,REC072,28,43,8.46,71
1783930003,REC075,26,54,8.46,80
1783930003,REC701,29,53,8.46,82
1783930003,REC702,26,50,8.46,76
1783930003,REC751,48,50,8.46,98
1783930003,REC752,48,50,8.46,98
1783930003,REC753,80,0,8.46,80
1783930003,REC754,175,0,8.46,175
1783930004,RAS101,24,50,8.17,74
1783930004,RAS102,27,53,8.17,80
1783930004,RAS103,24,50,8.17,74
1783930004,RME101,23,56,8.17,79
1783930004,RCS101,21,31,8.17,52
1783930004,RAS152,48,47,8.17,95
1783930004,RME151,43,45,8.17,88
1783930004,RCS151,41,40,8.17,81
1783930004,RCE151,42,40,8.17,82
1783930004,RAS203,18,49,7.13,67
1783930004,RAS201,20,45,7.13,65
1783930004,REE201,27,49,7.13,76
1783930004,RAS204,20,31,7.13,51
1783930004,REC201,18,30,7.13,48
1783930004,RAS251,44,49,7.13,93
1783930004,REE251,48,50,7.13,98
1783930004,RAS254,40,45,7.13,85
1783930004,RME252,36,42,7.13,78
1783930004,RAS301,18,28,6.5,46
1783930004,RVE301,18,62,6.5,80
1783930004,REE305,21,35,6.5,56
1783930004,REC301,22,21,6.5,43
1783930004,REC302,19,35,6.5,54
1783930004,REC303,20,47,6.5,67
1783930004,REC351,38,41,6.5,79
1783930004,REC352,40,41,6.5,81
1783930004,REC353,46,41,6.5,87
1783930004,REC354,36,38,6.5,74
1783930004,ROE047,18,41,6.38,59
1783930004,RAS402,17,39,6.38,56
1783930004,REC401,16,38,6.38,54
1783930004,REC402,16,46,6.38,62
1783930004,REC403,17,35,6.38,52
1783930004,RCS406,12,37,6.38,49
1783930004,REC451,38,35,6.38,73
1783930004,REC452,32,36,6.38,68
1783930004,REC453,39,40,6.38,79
1783930004,RCS456,44,45,6.38,89
1783930004,RAS501,22,47,7.29,69
1783930004,RAS502,21,43,7.29,64
1783930004,REC501A,20,51,7.29,71
1783930004,REC502,21,37,7.29,58
1783930004,REC503,14,42,7.29,56
1783930004,REC051,17,56,7.29,73
1783930004,REC551,39,43,7.29,82
1783930004,REC552,45,41,7.29,86
1783930004,REC553,37,40,7.29,77
1783930004,REC554,38,42,7.29,80
1783930004,RAS601,27,49,7.58,76
1783930004,RUC601,24,47,7.58,71
1783930004,RIC603,16,41,7.58,57
1783930004,REC601,27,49,7.58,76
1783930004,REC602,18,43,7.58,61
1783930004,REC064,18,43,7.58,61
1783930004,REC651,47,44,7.58,91
1783930004,REC652,43,43,7.58,86
1783930004,RIC653,33,40,7.58,73
1783930004,RIC651,38,41,7.58,79
1783930004,ROE072,24,38,7.92,62
1783930004,REC072,27,30,7.92,57
1783930004,REC075,25,46,7.92,71
1783930004,REC701,28,32,7.92,60
1783930004,REC702,25,56,7.92,81
1783930004,REC751,47,48,7.92,95
1783930004,REC752,32,48,7.92,80
1783930004,REC753,80,0,7.92,80
1783930004,REC754,175,0,7.92,175
1783930005,RAS101,23,36,7.46,59
1783930005,RAS102,29,43,7.46,72
1783930005,RAS103,28,43,7.46,71
1783930005,RME101,24,30,7.46,54
1783930005,RCS101,24,45,7.46,69
1783930005,RAS152,49,48,7.46,97
1783930005,RME151,44,43,7.46,87
1783930005,RCS151,44,39,7.46,83
1783930005,RCE151,44,40,7.46,84
1783930005,RAS203,22,63,7.92,85
1783930005,RAS201,20,47,7.92,67
1783930005,REE201,23,41,7.92,64
1783930005,RAS204,26,46,7.92,72
1783930005,REC201,30,38,7.92,68
1783930005,RAS251,46,42,7.92,88
1783930005,REE251,47,47,7.92,94
1783930005,RAS254,40,46,7.92,86
1783930005,RME252,46,40,7.92,86
1783930005,RAS301,20,63,7.33,83
1783930005,RVE301,21,28,7.33,49
1783930005,REE305,28,46,7.33,74
1783930005,REC301,20,37,7.33,57
1783930005,REC302,19,39,7.33,58
1783930005,REC303,23,56,7.33,79
1783930005,REC351,41,45,7.33,86
1783930005,REC352,42,35,7.33,77
1783930005,REC353,49,46,7.33,95
1783930005,REC354,38,39,7.33,77
1783930005,ROE047,22,48,7.71,70
1783930005,RAS402,16,43,7.71,59
1783930005,REC401,19,41,7.71,60
1783930005,REC402,21,51,7.71,72
1783930005,REC403,22,40,7.71,62
1783930005,RCS406,23,56,7.71,79
1783930005,REC451,41,35,7.71,76
1783930005,REC452,42,43,7.71,85
1783930005,REC453,47,44,7.71,91
1783930005,RCS456,47,46,7.71,93
1783930005,RAS501,23,34,7.29,57
1783930005,RAS502,24,41,7.29,65
1783930005,REC501A,23,39,7.29,62
1783930005,REC502,25,52,7.29,77
1783930005,REC503,19,35,7.29,54
1783930005,REC051,18,47,7.29,65
1783930005,REC551,46,42,7.29,88
1783930005,REC552,42,43,7.29,85
1783930005,REC553,43,42,7.29,85
1783930005,REC554,45,45,7.29,90
1783930005,RAS601,28,51,7.79,79
1783930005,RUC601,24,48,7.79,72
1783930005,RIC603,22,46,7.79,68
1783930005,REC601,27,50,7.79,77
1783930005,REC602,22,46,7.79,68
1783930005,REC064,18,44,7.79,62
1783930005,REC651,47,44,7.79,91
1783930005,REC652,43,43,7.79,86
1783930005,RIC653,43,43,7.79,86
1783930005,RIC651,42,43,7.79,85
1783930005,ROE072,25,39,8.13,64
1783930005,REC072,29,33,8.13,62
1783930005,REC075,27,44,8.13,71
1783930005,REC701,28,43,8.13,71
1783930005,REC702,27,53,8.13,80
1783930005,REC751,48,44,8.13,92
1783930005,REC752,41,44,8.13,85
1783930005,REC753,75,0,8.13,75
1783930005,REC754,160,0,8.13,160
1783930006,RAS101,21,43,7.46,64
1783930006,RAS102,19,44,7.46,63
1783930006,RAS103,22,40,7.46,62
1783930006,RME101,22,44,7.46,66
1783930006,RCS101,28,51,7.46,79
1783930006,RAS152,40,39,7.46,79
1783930006,RME151,42,42,7.46,84
1783930006,RCS151,48,48,7.46,96
1783930006,RCE151,40,38,7.46,78
1783930006,RAS203,15,31,7.13,46
1783930006,RAS201,15,50,7.13,65
1783930006,REE201,25,42,7.13,67
1783930006,RAS204,23,45,7.13,68
1783930006,REC201,21,45,7.13,66
1783930006,RAS251,40,43,7.13,83
1783930006,REE251,49,45,7.13,94
1783930006,RAS254,40,45,7.13,85
1783930006,RME252,44,44,7.13,88
1783930006,RAS301,18,33,6.71,51
1783930006,RVE301,17,38,6.71,55
1783930006,REE305,25,55,6.71,80
1783930006,REC301,23,30,6.71,53
1783930006,REC302,18,41,6.71,59
1783930006,REC303,22,23,6.71,45
1783930006,REC351,39,42,6.71,81
1783930006,REC352,40,39,6.71,79
1783930006,REC353,39,44,6.71,83
1783930006,REC354,37,45,6.71,82
1783930006,ROE047,25,42,7.83,67
1783930006,RAS402,24,43,7.83,67
1783930006,REC401,24,43,7.83,67
1783930006,REC402,17,60,7.83,77
1783930006,REC403,17,54,7.83,71
1783930006,RCS406,21,53,7.83,74
1783930006,REC451,44,42,7.83,86
1783930006,REC452,44,46,7.83,90
1783930006,REC453,40,42,7.83,82
1783930006,RCS456,47,44,7.83,91
1783930006,RAS501,26,48,7.29,74
1783930006,RAS502,24,45,7.29,69
1783930006,REC501A,22,40,7.29,62
1783930006,REC502,24,43,7.29,67
1783930006,REC503,16,32,7.29,48
1783930006,REC051,23,56,7.29,79
1783930006,REC551,44,45,7.29,89
1783930006,REC552,46,41,7.29,87
1783930006,REC553,37,40,7.29,77
1783930006,REC554,43,35,7.29,78
1783930006,RAS601,28,51,7.92,79
1783930006,RUC601,24,48,7.92,72
1783930006,RIC603,16,42,7.92,58
1783930006,REC601,29,51,7.92,80
1783930006,REC602,26,49,7.92,75
1783930006,REC064,18,44,7.92,62
1783930006,REC651,46,44,7.92,90
1783930006,REC652,44,43,7.92,87
1783930006,RIC653,34,40,7.92,74
1783930006,RIC651,45,44,7.92,89
1783930006,ROE072,25,43,8.29,68
1783930006,REC072,28,35,8.29,63
1783930006,REC075,28,44,8.29,72
1783930006,REC701,30,40,8.29,70
1783930006,REC702,28,50,8.29,78
1783930006,REC751,48,46,8.29,94
1783930006,REC752,40,46,8.29,86
1783930006,REC753,90,0,8.29,90
1783930006,REC754,180,0,8.29,180
1783930007,RAS101,17,28,6.5,45
1783930007,RAS102,19,41,6.5,60
1783930007,RAS103,22,37,6.5,59
1783930007,RME101,18,43,6.5,61
1783930007,RCS101,20,24,6.5,44
1783930007,RAS152,40,39,6.5,79
1783930007,RME151,40,43,6.5,83
1783930007,RCS151,40,41,6.5,81
1783930007,RCE151,44,39,6.5,83
1783930007,RAS203,15,49,6.67,64
1783930007,RAS201,15,44,6.67,59
1783930007,REE201,20,27,6.67,47
1783930007,RAS204,23,38,6.67,61
1783930007,REC201,15,43,6.67,58
1783930007,RAS251,42,44,6.67,86
1783930007,REE251,38,46,6.67,84
1783930007,RAS254,40,47,6.67,87
1783930007,RME252,31,43,6.67,74
1783930007,RAS301,16,41,7.0,57
1783930007,RVE301,22,35,7.0,57
1783930007,REE305,24,41,7.0,65
1783930007,REC301,22,45,7.0,67
1783930007,REC302,17,43,7.0,60
1783930007,REC303,17,53,7.0,70
1783930007,REC351,39,45,7.0,84
1783930007,REC352,34,38,7.0,72
1783930007,REC353,36,37,7.0,73
1783930007,REC354,28,37,7.0,65
1783930007,ROE047,20,49,7.08,69
1783930007,RAS402,22,50,7.08,72
1783930007,REC401,17,36,7.08,53
1783930007,REC402,16,55,7.08,71
1783930007,REC403,15,51,7.08,66
1783930007,RCS406,16,33,7.08,49
1783930007,REC451,38,39,7.08,77
1783930007,REC452,33,36,7.08,69
1783930007,REC453,37,40,7.08,77
1783930007,RCS456,41,41,7.08,82
1783930007,RAS501,25,47,7.54,72
1783930007,RAS502,25,39,7.54,64
1783930007,REC501A,20,32,7.54,52
1783930007,REC502,22,47,7.54,69
1783930007,REC503,21,55,7.54,76
1783930007,REC051,23,52,7.54,75
1783930007,REC551,37,47,7.54,84
1783930007,REC552,48,40,7.54,88
1783930007,REC553,38,40,7.54,78
1783930007,REC554,36,36,7.54,72
1783930007,RAS601,28,50,7.54,78
1783930007,RUC601,23,46,7.54,69
1783930007,RIC603,19,43,7.54,62
1783930007,REC601,19,43,7.54,62
1783930007,REC602,25,48,7.54,73
1783930007,REC064,22,45,7.54,67
1783930007,REC651,44,42,7.54,86
1783930007,REC652,41,41,7.54,82
1783930007,RIC653,40,41,7.54,81
1783930007,RIC651,33,39,7.54,72
1783930007,ROE072,24,32,7.5,56
1783930007,REC072,25,39,7.5,64
1783930007,REC075,25,37,7.5,62
1783930007,REC701,20,33,7.5,53
1783930007,REC702,25,49,7.5,74
1783930007,REC751,45,42,7.5,87
1783930007,REC752,36,42,7.5,78
1783930007,REC753,88,0,7.5,88
1783930007,REC754,180,0,7.5,180
1783930008,RAS101,16,56,7.33,72
1783930008,RAS102,22,33,7.33,55
1783930008,RAS103,25,51,7.33,76
1783930008,RME101,22,40,7.33,62
1783930008,RCS101,24,22,7.33,46
1783930008,RAS152,44,43,7.33,87
1783930008,RME151,42,46,7.33,88
1783930008,RCS151,44,40,7.33,84
1783930008,RCE151,43,42,7.33,85
1783930008,RAS203,19,42,7.13,61
1783930008,RAS201,15,41,7.13,56
1783930008,REE201,22,48,7.13,70
1783930008,RAS204,19,30,7.13,49
1783930008,REC201,16,50,7.13,66
1783930008,RAS251,38,44,7.13,82
1783930008,REE251,48,47,7.13,95
1783930008,RAS254,40,47,7.13,87
1783930008,RME252,33,45,7.13,78
1783930008,RAS301,18,38,6.88,56
1783930008,RVE301,20,32,6.88,52
1783930008,REE305,23,42,6.88,65
1783930008,REC301,24,36,6.88,60
1783930008,REC302,17,37,6.88,54
1783930008,REC303,22,54,6.88,76
1783930008,REC351,41,40,6.88,81
1783930008,REC352,36,34,6.88,70
1783930008,REC353,36,43,6.88,79
1783930008,REC354,37,35,6.88,72
1783930008,ROE047,21,44,6.71,65
1783930008,RAS402,22,30,6.71,52
1783930008,REC401,19,36,6.71,55
1783930008,REC402,17,47,6.71,64
1783930008,REC403,18,31,6.71,49
1783930008,RCS406,15,46,6.71,61
1783930008,REC451,37,35,6.71,72
1783930008,REC452,36,38,6.71,74
1783930008,REC453,37,39,6.71,76
1783930008,RCS456,41,42,6.71,83
1783930008,RAS501,26,42,6.63,68
1783930008,RAS502,23,33,6.63,56
1783930008,REC501A,22,42,6.63,64
1783930008,REC502,20,34,6.63,54
1783930008,REC503,16,49,6.63,65
1783930008,REC051,17,32,6.63,49
1783930008,REC551,42,47,6.63,89
1783930008,REC552,45,41,6.63,86
1783930008,REC553,37,40,6.63,77
1783930008,REC554,41,36,6.63,77
1783930008,RAS601,29,48,7.33,77
1783930008,RUC601,25,46,7.33,71
1783930008,RIC603,16,39,7.33,55
1783930008,REC601,19,41,7.33,60
1783930008,REC602,25,46,7.33,71
1783930008,REC064,16,39,7.33,55
1783930008,REC651,42,42,7.33,84
1783930008,REC652,42,42,7.33,84
1783930008,RIC653,37,40,7.33,77
1783930008,RIC651,35,40,7.33,75
1783930008,ROE072,23,33,6.79,56
1783930008,REC072,20,36,6.79,56
1783930008,REC075,21,41,6.79,62
1783930008,REC701,20,28,6.79,48
1783930008,REC702,21,35,6.79,56
1783930008,REC751,38,42,6.79,80
1783930008,REC752,47,42,6.79,89
1783930008,REC753,77,0,6.79,77
1783930008,REC754,160,0,6.79,160
1783930009,RAS101,22,27,7.79,49
1783930009,RAS102,28,50,7.79,78
1783930009,RAS103,24,49,7.79,73
1783930009,RME101,25,51,7.79,76
1783930009,RCS101,24,47,7.79,71
1783930009,RAS152,47,48,7.79,95
1783930009,RME151,42,45,7.79,87
1783930009,RCS151,44,48,7.79,92
1783930009,RCE151,42,39,7.79,81
1783930009,RAS203,19,49,8.0,68
1783930009,RAS201,18,53,8.0,71
1783930009,REE201,28,58,8.0,86
1783930009,RAS204,19,34,8.0,53
1783930009,REC201,25,51,8.0,76
1783930009,RAS251,44,45,8.0,89
1783930009,REE251,47,46,8.0,93
1783930009,RAS254,40,42,8.0,82
1783930009,RME252,43,40,8.0,83
1783930009,RAS301,26,30,7.29,56
1783930009,RVE301,19,47,7.29,66
1783930009,REE305,27,44,7.29,71
1783930009,REC301,23,41,7.29,64
1783930009,REC302,22,29,7.29,51
1783930009,REC303,28,49,7.29,77
1783930009,REC351,44,42,7.29,86
1783930009,REC352,40,42,7.29,82
1783930009,REC353,46,48,7.29,94
1783930009,REC354,41,40,7.29,81
1783930009,ROE047,21,43,5.58,64
1783930009,RAS402,17,23,5.58,40
1783930009,REC401,15,24,5.58,39
1783930009,REC402,16,49,5.58,65
1783930009,REC403,16,29,5.58,45
1783930009,RCS406,19,47,5.58,66
1783930009,REC451,35,37,5.58,72
1783930009,REC452,33,36,5.58,69
1783930009,REC453,36,39,5.58,75
1783930009,RCS456,30,38,5.58,68
1783930009,RAS501,22,44,5.92,66
1783930009,RAS502,21,24,5.92,45
1783930009,REC501A,19,38,5.92,57
1783930009,REC502,20,46,5.92,66
1783930009,REC503,19,56,5.92,75
1783930009,REC051,13,22,5.92,35
1783930009,REC551,44,47,5.92,91
1783930009,REC552,42,45,5.92,87
1783930009,REC553,38,44,5.92,82
1783930009,REC554,43,36,5.92,79
1783930009,RAS601,28,49,6.88,77
1783930009,RUC601,23,45,6.88,68
1783930009,RIC603,12,37,6.88,49
1783930009,REC601,23,45,6.88,68
1783930009,REC602,15,40,6.88,55
1783930009,REC064,21,44,6.88,65
1783930009,REC651,40,42,6.88,82
1783930009,REC652,35,41,6.88,76
1783930009,RIC653,30,39,6.88,69
1783930009,RIC651,30,39,6.88,69
1783930009,ROE072,25,29,6.83,54
1783930009,REC072,21,35,6.83,56
1783930009,REC075,22,38,6.83,60
1783930009,REC701,15,35,6.83,50
1783930009,REC702,22,33,6.83,55
1783930009,REC751,39,46,6.83,85
1783930009,REC752,41,46,6.83,87
1783930009,REC753,70,0,6.83,70
1783930009,REC754,140,0,6.83,140
1783930010,RAS101,15,47,7.42,62
1783930010,RAS102,20,45,7.42,65
1783930010,RAS103,22,51,7.42,73
1783930010,RME101,23,40,7.42,63
1783930010,RCS101,23,32,7.42,55
1783930010,RAS152,40,38,7.42,78
1783930010,RME151,45,41,7.42,86
1783930010,RCS151,43,40,7.42,83
1783930010,RCE151,44,39,7.42,83
1783930010,RAS203,15,32,7.13,47
1783930010,RAS201,20,45,7.13,65
1783930010,REE201,22,52,7.13,74
1783930010,RAS204,23,41,7.13,64
1783930010,REC201,16,42,7.13,58
1783930010,RAS251,44,43,7.13,87
1783930010,REE251,46,46,7.13,92
1783930010,RAS254,40,45,7.13,85
1783930010,RME252,36,44,7.13,80
1783930010,RAS301,18,31,6.67,49
1783930010,RVE301,22,44,6.67,66
1783930010,REE305,23,44,6.67,67
1783930010,REC301,25,27,6.67,52
1783930010,REC302,18,48,6.67,66
1783930010,REC303,19,48,6.67,67
1783930010,REC351,39,37,6.67,76
1783930010,REC352,36,33,6.67,69
1783930010,REC353,38,39,6.67,77
1783930010,REC354,36,35,6.67,71
1783930010,ROE047,24,50,6.88,74
1783930010,RAS402,21,27,6.88,48
1783930010,REC401,18,37,6.88,55
1783930010,REC402,18,42,6.88,60
1783930010,REC403,18,35,6.88,53
1783930010,RCS406,16,41,6.88,57
1783930010,REC451,41,38,6.88,79
1783930010,REC452,42,44,6.88,86
1783930010,REC453,44,48,6.88,92
1783930010,RCS456,41,42,6.88,83
1783930010,RAS501,23,37,6.71,60
1783930010,RAS502,23,51,6.71,74
1783930010,REC501A,17,38,6.71,55
1783930010,REC502,19,54,6.71,73
1783930010,REC503,10,49,6.71,59
1783930010,REC051,15,29,6.71,44
1783930010,REC551,39,38,6.71,77
1783930010,REC552,38,41,6.71,79
1783930010,REC553,35,40,6.71,75
1783930010,REC554,38,35,6.71,73
1783930010,RAS601,27,48,7.33,75
1783930010,RUC601,24,46,7.33,70
1783930010,RIC603,14,39,7.33,53
1783930010,REC601,19,42,7.33,61
1783930010,REC602,20,43,7.33,63
1783930010,REC064,19,42,7.33,61
1783930010,REC651,44,42,7.33,86
1783930010,REC652,38,40,7.33,78
1783930010,RIC653,37,40,7.33,77
1783930010,RIC651,33,39,7.33,72
1783930010,ROE072,25,43,7.33,68
1783930010,REC072,26,42,7.33,68
1783930010,REC075,26,39,7.33,65
1783930010,REC701,21,40,7.33,61
1783930010,REC702,26,28,7.33,54
1783930010,REC751,44,42,7.33,86
1783930010,REC752,36,42,7.33,78
1783930010,REC753,75,0,7.33,75
1783930010,REC754,160,0,7.33,160
1783930011,RAS101,24,51,8.46,75
1783930011,RAS102,25,53,8.46,78
1783930011,RAS103,27,53,8.46,80
1783930011,RME101,21,53,8.46,74
1783930011,RCS101,27,50,8.46,77
1783930011,RAS152,46,47,8.46,93
1783930011,RME151,41,46,8.46,87
1783930011,RCS151,47,48,8.46,95
1783930011,RCE151,43,40,8.46,83
1783930011,RAS203,25,63,8.33,88
1783930011,RAS201,20,61,8.33,81
1783930011,REE201,19,51,8.33,70
1783930011,RAS204,24,40,8.33,64
1783930011,REC201,24,50,8.33,74
1783930011,RAS251,44,44,8.33,88
1783930011,REE251,38,46,8.33,84
1783930011,RAS254,38,47,8.33,85
1783930011,RME252,30,42,8.33,72
1783930011,RAS301,23,50,8.25,73
1783930011,RVE301,18,33,8.25,51
1783930011,REE305,24,53,8.25,77
1783930011,REC301,19,44,8.25,63
1783930011,REC302,26,60,8.25,86
1783930011,REC303,29,63,8.25,92
1783930011,REC351,46,48,8.25,94
1783930011,REC352,38,38,8.25,76
1783930011,REC353,49,49,8.25,98
1783930011,REC354,42,47,8.25,89
1783930011,ROE047,19,47,7.63,66
1783930011,RAS402,21,44,7.63,65
1783930011,REC401,18,43,7.63,61
1783930011,REC402,28,65,7.63,93
1783930011,REC403,23,39,7.63,62
1783930011,RCS406,19,34,7.63,53
1783930011,REC451,38,40,7.63,78
1783930011,REC452,35,39,7.63,74
1783930011,REC453,39,42,7.63,81
1783930011,RCS456,44,39,7.63,83
1783930011,RAS501,22,36,7.92,58
1783930011,RAS502,23,50,7.92,73
1783930011,REC501A,21,36,7.92,57
1783930011,REC502,27,56,7.92,83
1783930011,REC503,23,53,7.92,76
1783930011,REC051,23,50,7.92,73
1783930011,REC551,38,45,7.92,83
1783930011,REC552,48,45,7.92,93
1783930011,REC553,46,44,7.92,90
1783930011,REC554,37,45,7.92,82
1783930011,RAS601,27,54,8.04,81
1783930011,RUC601,24,52,8.04,76
1783930011,RIC603,19,48,8.04,67
1783930011,REC601,19,48,8.04,67
1783930011,REC602,26,53,8.04,79
1783930011,REC064,25,53,8.04,78
1783930011,REC651,45,46,8.04,91
1783930011,REC652,46,46,8.04,92
1783930011,RIC653,41,44,8.04,85
1783930011,RIC651,30,41,8.04,71
1783930011,ROE072,23,36,7.38,59
1783930011,REC072,13,39,7.38,52
1783930011,REC075,19,42,7.38,61
1783930011,REC701,24,39,7.38,63
1783930011,REC702,24,39,7.38,63
1783930011,REC751,35,48,7.38,83
1783930011,REC752,48,48,7.38,96
1783930011,REC753,81,0,7.38,81
1783930011,REC754,170,0,7.38,170
1783930012,RAS101,17,30,6.5,47
1783930012,RAS102,19,33,6.5,52
1783930012,RAS103,22,40,6.5,62
1783930012,RME101,20,34,6.5,54
1783930012,RCS101,22,26,6.5,48
1783930012,RAS152,40,40,6.5,80
1783930012,RME151,42,46,6.5,88
1783930012,RCS151,42,41,6.5,83
1783930012,RCE151,44,40,6.5,84
1783930012,RAS203,15,45,7.5,60
1783930012,RAS201,15,62,7.5,77
1783930012,REE201,26,41,7.5,67
1783930012,RAS204,27,37,7.5,64
1783930012,REC201,20,36,7.5,56
1783930012,RAS251,42,45,7.5,87
1783930012,REE251,44,46,7.5,90
1783930012,RAS254,48,48,7.5,96
1783930012,RME252,40,45,7.5,85
1783930012,RAS301,19,46,7.46,65
1783930012,RVE301,25,37,7.46,62
1783930012,REE305,23,61,7.46,84
1783930012,REC301,27,47,7.46,74
1783930012,REC302,16,46,7.46,62
1783930012,REC303,22,35,7.46,57
1783930012,REC351,45,40,7.46,85
1783930012,REC352,38,36,7.46,74
1783930012,REC353,36,43,7.46,79
1783930012,REC354,36,43,7.46,79
1783930012,ROE047,25,46,8.0,71
1783930012,RAS402,22,50,8.0,72
1783930012,REC401,25,46,8.0,71
1783930012,REC402,24,38,8.0,62
1783930012,REC403,27,52,8.0,79
1783930012,RCS406,27,46,8.0,73
1783930012,REC451,45,40,8.0,85
1783930012,REC452,41,43,8.0,84
1783930012,REC453,42,46,8.0,88
1783930012,RCS456,44,37,8.0,81
1783930012,RAS501,30,55,8.46,85
1783930012,RAS502,28,50,8.46,78
1783930012,REC501A,22,49,8.46,71
1783930012,REC502,25,46,8.46,71
1783930012,REC503,24,61,8.46,85
1783930012,REC051,24,46,8.46,70
1783930012,REC551,38,45,8.46,83
1783930012,REC552,45,45,8.46,90
1783930012,REC553,47,44,8.46,91
1783930012,REC554,37,42,8.46,79
1783930012,RAS601,27,51,8.21,78
1783930012,RUC601,23,48,8.21,71
1783930012,RIC603,28,52,8.21,80
1783930012,REC601,25,50,8.21,75
1783930012,REC602,27,51,8.21,78
1783930012,REC064,18,45,8.21,63
1783930012,REC651,44,43,8.21,87
1783930012,REC652,47,44,8.21,91
1783930012,RIC653,46,44,8.21,90
1783930012,RIC651,40,42,8.21,82
1783930012,ROE072,24,49,8.0,73
1783930012,REC072,29,48,8.0,77
1783930012,REC075,27,41,8.0,68
1783930012,REC701,28,38,8.0,66
1783930012,REC702,27,46,8.0,73
1783930012,REC751,48,46,8.0,94
1783930012,REC752,42,46,8.0,88
1783930012,REC753,86,0,8.0,86
1783930012,REC754,170,0,8.0,170
1783930013,RAS101,19,35,6.88,54
1783930013,RAS102,28,47,6.88,75
1783930013,RAS103,22,30,6.88,52
1783930013,RME101,17,33,6.88,50
1783930013,RCS101,21,28,6.88,49
1783930013,RAS152,47,48,6.88,95
1783930013,RME151,40,43,6.88,83
1783930013,RCS151,41,43,6.88,84
1783930013,RCE151,42,40,6.88,82
1783930013,RAS203,15,49,6.83,64
1783930013,RAS201,15,33,6.83,48
1783930013,REE201,22,41,6.83,63
1783930013,RAS204,21,32,6.83,53
1783930013,REC201,17,40,6.83,57
1783930013,RAS251,41,46,6.83,87
1783930013,REE251,45,46,6.83,91
1783930013,RAS254,45,38,6.83,83
1783930013,RME252,44,43,6.83,87
1783930013,RAS301,18,28,6.67,46
1783930013,RVE301,22,48,6.67,70
1783930013,REE305,23,47,6.67,70
1783930013,REC301,23,25,6.67,48
1783930013,REC302,17,28,6.67,45
1783930013,REC303,17,54,6.67,71
1783930013,REC351,43,46,6.67,89
1783930013,REC352,32,38,6.67,70
1783930013,REC353,39,37,6.67,76
1783930013,REC354,36,35,6.67,71
1783930013,ROE047,21,48,6.71,69
1783930013,RAS402,20,28,6.71,48
1783930013,REC401,23,42,6.71,65
1783930013,REC402,18,46,6.71,64
1783930013,REC403,18,39,6.71,57
1783930013,RCS406,15,40,6.71,55
1783930013,REC451,42,35,6.71,77
1783930013,REC452,35,39,6.71,74
1783930013,REC453,40,44,6.71,84
1783930013,RCS456,41,37,6.71,78
1783930013,RAS501,25,49,7.17,74
1783930013,RAS502,24,42,7.17,66
1783930013,REC501A,15,37,7.17,52
1783930013,REC502,28,41,7.17,69
1783930013,REC503,15,47,7.17,62
1783930013,REC051,17,38,7.17,55
1783930013,REC551,46,35,7.17,81
1783930013,REC552,40,45,7.17,85
1783930013,REC553,37,44,7.17,81
1783930013,REC554,45,36,7.17,81
1783930013,RAS601,29,48,7.13,77
1783930013,RUC601,27,47,7.13,74
1783930013,RIC603,13,37,7.13,50
1783930013,REC601,19,41,7.13,60
1783930013,REC602,19,41,7.13,60
1783930013,REC064,16,39,7.13,55
1783930013,REC651,43,42,7.13,85
1783930013,REC652,37,40,7.13,77
1783930013,RIC653,34,39,7.13,73
1783930013,RIC651,30,38,7.13,68
1783930013,ROE072,23,40,7.33,63
1783930013,REC072,24,37,7.33,61
1783930013,REC075,24,47,7.33,71
1783930013,REC701,18,35,7.33,53
1783930013,REC702,24,31,7.33,55
1783930013,REC751,44,44,7.33,88
1783930013,REC752,38,44,7.33,82
1783930013,REC753,80,0,7.33,80
1783930013,REC754,145,0,7.33,145
1783930014,RAS101,16,43,7.67,59
1783930014,RAS102,29,57,7.67,86
1783930014,RAS103,19,55,7.67,74
1783930014,RME101,16,47,7.67,63
1783930014,RCS101,24,30,7.67,54
1783930014,RAS152,48,48,7.67,96
1783930014,RME151,40,44,7.67,84
1783930014,RCS151,44,41,7.67,85
1783930014,RCE151,44,41,7.67,85
1783930014,RAS203,26,63,7.83,89
1783930014,RAS201,15,52,7.83,67
1783930014,REE201,27,35,7.83,62
1783930014,RAS204,26,48,7.83,74
1783930014,REC201,25,31,7.83,56
1783930014,RAS251,44,48,7.83,92
1783930014,REE251,45,49,7.83,94
1783930014,RAS254,48,45,7.83,93
1783930014,RME252,41,41,7.83,82
1783930014,RAS301,14,45,6.75,59
1783930014,RVE301,18,46,6.75,64
1783930014,REE305,22,36,6.75,58
1783930014,REC301,26,35,6.75,61
1783930014,REC302,16,49,6.75,65
1783930014,REC303,16,34,6.75,50
1783930014,REC351,44,44,6.75,88
1783930014,REC352,40,36,6.75,76
1783930014,REC353,35,36,6.75,71
1783930014,REC354,36,33,6.75,69
1783930014,ROE047,22,42,7.63,64
1783930014,RAS402,21,46,7.63,67
1783930014,REC401,23,39,7.63,62
1783930014,REC402,23,54,7.63,77
1783930014,REC403,22,53,7.63,75
1783930014,RCS406,21,43,7.63,64
1783930014,REC451,40,40,7.63,80
1783930014,REC452,38,48,7.63,86
1783930014,REC453,44,46,7.63,90
1783930014,RCS456,41,38,7.63,79
1783930014,RAS501,25,39,7.5,64
1783930014,RAS502,24,54,7.5,78
1783930014,REC501A,21,42,7.5,63
1783930014,REC502,22,38,7.5,60
1783930014,REC503,15,45,7.5,60
1783930014,REC051,15,47,7.5,62
1783930014,REC551,46,38,7.5,84
1783930014,REC552,48,42,7.5,90
1783930014,REC553,41,43,7.5,84
1783930014,REC554,45,40,7.5,85
1783930014,RAS601,28,52,7.29,80
1783930014,RUC601,24,49,7.29,73
1783930014,RIC603,15,43,7.29,58
1783930014,REC601,19,45,7.29,64
1783930014,REC602,21,47,7.29,68
1783930014,REC064,15,43,7.29,58
1783930014,REC651,42,43,7.29,85
1783930014,REC652,35,41,7.29,76
1783930014,RIC653,36,41,7.29,77
1783930014,RIC651,35,41,7.29,76
1783930014,ROE072,22,35,7.17,57
1783930014,REC072,17,47,7.17,64
1783930014,REC075,19,46,7.17,65
1783930014,REC701,18,35,7.17,53
1783930014,REC702,19,49,7.17,68
1783930014,REC751,36,42,7.17,78
1783930014,REC752,38,42,7.17,80
1783930014,REC753,75,0,7.17,75
1783930014,REC754,170,0,7.17,170
1783930015,RAS101,17,31,5.75,48
1783930015,RAS102,19,21,5.75,40
1783930015,RAS103,23,36,5.75,59
1783930015,RME101,18,25,5.75,43
1783930015,RCS101,20,34,5.75,54
1783930015,RAS152,40,42,5.75,82
1783930015,RME151,40,47,5.75,87
1783930015,RCS151,40,39,5.75,79
1783930015,RCE151,43,38,5.75,81
1783930015,RAS203,15,29,5.92,44
1783930015,RAS201,15,34,5.92,49
1783930015,REE201,19,30,5.92,49
1783930015,RAS204,21,36,5.92,57
1783930015,REC201,13,41,5.92,54
1783930015,RAS251,39,44,5.92,83
1783930015,REE251,43,48,5.92,91
1783930015,RAS254,35,47,5.92,82
1783930015,RME252,35,41,5.92,76
1783930015,RAS301,17,26,5.38,43
1783930015,RVE301,21,37,5.38,58
1783930015,REE305,28,39,5.38,67
1783930015,REC301,19,23,5.38,42
1783930015,REC302,15,25,5.38,40
1783930015,REC303,18,30,5.38,48
1783930015,REC351,40,36,5.38,76
1783930015,REC352,38,34,5.38,72
1783930015,REC353,39,40,5.38,79
1783930015,REC354,31,33,5.38,64
1783930015,ROE047,20,42,6.33,62
1783930015,RAS402,23,43,6.33,66
1783930015,REC401,15,35,6.33,50
1783930015,REC402,15,27,6.33,42
1783930015,REC403,15,42,6.33,57
1783930015,RCS406,17,36,6.33,53
1783930015,REC451,40,39,6.33,79
1783930015,REC452,38,41,6.33,79
1783930015,REC453,38,41,6.33,79
1783930015,RCS456,44,37,6.33,81
1783930015,RAS501,28,21,6.29,49
1783930015,RAS502,24,45,6.29,69
1783930015,REC501A,16,48,6.29,64
1783930015,REC502,19,40,6.29,59
1783930015,REC503,14,47,6.29,61
1783930015,REC051,17,27,6.29,44
1783930015,REC551,36,35,6.29,71
1783930015,REC552,45,41,6.29,86
1783930015,REC553,37,41,6.29,78
1783930015,REC554,35,36,6.29,71
1783930015,RAS601,27,42,6.75,69
1783930015,RUC601,24,40,6.75,64
1783930015,RIC603,17,35,6.75,52
1783930015,REC601,21,38,6.75,59
1783930015,REC602,21,38,6.75,59
1783930015,REC064,18,36,6.75,54
1783930015,REC651,47,42,6.75,89
1783930015,REC652,35,39,6.75,74
1783930015,RIC653,40,40,6.75,80
1783930015,RIC651,48,42,6.75,90
1783930015,ROE072,22,28,6.92,50
1783930015,REC072,25,38,6.92,63
1783930015,REC075,25,44,6.92,69
1783930015,REC701,27,22,6.92,49
1783930015,REC702,25,39,6.92,64
1783930015,REC751,43,44,6.92,87
1783930015,REC752,37,44,6.92,81
1783930015,REC753,76,0,6.92,76
1783930015,REC754,155,0,6.92,155
1783930016,RAS101,26,53,8.88,79
1783930016,RAS102,29,44,8.88,73
1783930016,RAS103,28,65,8.88,93
1783930016,RME101,28,62,8.88,90
1783930016,RCS101,28,34,8.88,62
1783930016,RAS152,48,48,8.88,96
1783930016,RME151,47,48,8.88,95
1783930016,RCS151,48,44,8.88,92
1783930016,RCE151,44,42,8.88,86
1783930016,RAS203,28,56,8.13,84
1783930016,RAS201,22,51,8.13,73
1783930016,REE201,29,39,8.13,68
1783930016,RAS204,26,31,8.13,57
1783930016,REC201,24,51,8.13,75
1783930016,RAS251,46,43,8.13,89
1783930016,REE251,49,46,8.13,95
1783930016,RAS254,45,45,8.13,90
1783930016,RME252,43,47,8.13,90
1783930016,RAS301,27,51,8.08,78
1783930016,RVE301,21,44,8.08,65
1783930016,REE305,28,47,8.08,75
1783930016,REC301,28,48,8.08,76
1783930016,REC302,29,38,8.08,67
1783930016,REC303,30,53,8.08,83
1783930016,REC351,43,45,8.08,88
1783930016,REC352,46,36,8.08,82
1783930016,REC353,50,49,8.08,99
1783930016,REC354,49,44,8.08,93
1783930016,ROE047,29,48,8.71,77
1783930016,RAS402,27,53,8.71,80
1783930016,REC401,30,52,8.71,82
1783930016,REC402,28,54,8.71,82
1783930016,REC403,30,50,8.71,80
1783930016,RCS406,26,42,8.71,68
1783930016,REC451,48,47,8.71,95
1783930016,REC452,46,49,8.71,95
1783930016,REC453,47,49,8.71,96
1783930016,RCS456,44,43,8.71,87
1783930016,RAS501,30,49,8.96,79
1783930016,RAS502,29,59,8.96,88
1783930016,REC501A,30,56,8.96,86
1783930016,REC502,30,48,8.96,78
1783930016,REC503,30,60,8.96,90
1783930016,REC051,29,56,8.96,85
1783930016,REC551,46,47,8.96,93
1783930016,REC552,48,47,8.96,95
1783930016,REC553,49,48,8.96,97
1783930016,REC554,45,42,8.96,87
1783930016,RAS601,28,55,9.04,83
1783930016,RUC601,25,53,9.04,78
1783930016,RIC603,29,55,9.04,84
1783930016,REC601,30,56,9.04,86
1783930016,REC602,28,55,9.04,83
1783930016,REC064,29,55,9.04,84
1783930016,REC651,49,47,9.04,96
1783930016,REC652,49,47,9.04,96
1783930016,RIC653,49,47,9.04,96
1783930016,RIC651,48,46,9.04,94
1783930016,ROE072,28,42,8.46,70
1783930016,REC072,28,47,8.46,75
1783930016,REC075,29,42,8.46,71
1783930016,REC701,30,40,8.46,70
1783930016,REC702,29,49,8.46,78
1783930016,REC751,48,50,8.46,98
1783930016,REC752,49,50,8.46,99
1783930016,REC753,90,0,8.46,90
1783930016,REC754,165,0,8.46,165
1783930017,RAS101,25,54,7.75,79
1783930017,RAS102,28,50,7.75,78
1783930017,RAS103,24,42,7.75,66
1783930017,RME101,27,40,7.75,67
1783930017,RCS101,27,23,7.75,50
1783930017,RAS152,47,47,7.75,94
1783930017,RME151,46,44,7.75,90
1783930017,RCS151,47,45,7.75,92
1783930017,RCE151,46,39,7.75,85
1783930017,RAS203,29,42,7.71,71
1783930017,RAS201,18,45,7.71,63
1783930017,REE201,26,36,7.71,62
1783930017,RAS204,24,40,7.71,64
1783930017,REC201,23,40,7.71,63
1783930017,RAS251,47,45,7.71,92
1783930017,REE251,46,46,7.71,92
1783930017,RAS254,46,45,7.71,91
1783930017,RME252,38,45,7.71,83
1783930017,RAS301,23,39,7.25,62
1783930017,RVE301,16,37,7.25,53
1783930017,REE305,29,50,7.25,79
1783930017,REC301,22,42,7.25,64
1783930017,REC302,24,25,7.25,49
1783930017,REC303,23,60,7.25,83
1783930017,REC351,39,46,7.25,85
1783930017,REC352,44,43,7.25,87
1783930017,REC353,40,46,7.25,86
1783930017,REC354,42,40,7.25,82
1783930017,ROE047,19,40,6.54,59
1783930017,RAS402,20,32,6.54,52
1783930017,REC401,18,32,6.54,50
1783930017,REC402,21,31,6.54,52
1783930017,REC403,21,39,6.54,60
1783930017,RCS406,18,40,6.54,58
1783930017,REC451,40,37,6.54,77
1783930017,REC452,36,40,6.54,76
1783930017,REC453,39,41,6.54,80
1783930017,RCS456,44,42,6.54,86
1783930017,RAS501,22,36,7.33,58
1783930017,RAS502,21,44,7.33,65
1783930017,REC501A,25,40,7.33,65
1783930017,REC502,19,47,7.33,66
1783930017,REC503,16,42,7.33,58
1783930017,REC051,23,48,7.33,71
1783930017,REC551,44,47,7.33,91
1783930017,REC552,48,43,7.33,91
1783930017,REC553,39,42,7.33,81
1783930017,REC554,43,42,7.33,85
1783930017,RAS601,28,49,8.0,77
1783930017,RUC601,24,46,8.0,70
1783930017,RIC603,28,49,8.0,77
1783930017,REC601,27,48,8.0,75
1783930017,REC602,23,45,8.0,68
1783930017,REC064,18,42,8.0,60
1783930017,REC651,46,45,8.0,91
1783930017,REC652,46,45,8.0,91
1783930017,RIC653,47,45,8.0,92
1783930017,RIC651,40,43,8.0,83
1783930017,ROE072,27,32,7.42,59
1783930017,REC072,26,38,7.42,64
1783930017,REC075,26,39,7.42,65
1783930017,REC701,29,27,7.42,56
1783930017,REC702,26,43,7.42,69
1783930017,REC751,44,50,7.42,94
1783930017,REC752,47,50,7.42,97
1783930017,REC753,78,0,7.42,78
1783930017,REC754,180,0,7.42,180
1783930018,RAS101,26,46,8.33,72
1783930018,RAS102,29,59,8.33,88
1783930018,RAS103,25,47,8.33,72
1783930018,RME101,25,51,8.33,76
1783930018,RCS101,27,41,8.33,68
1783930018,RAS152,48,48,8.33,96
1783930018,RME151,45,48,8.33,93
1783930018,RCS151,47,41,8.33,88
1783930018,RCE151,47,40,8.33,87
1783930018,RAS203,20,32,7.5,52
1783930018,RAS201,18,38,7.5,56
1783930018,REE201,26,36,7.5,62
1783930018,RAS204,28,51,7.5,79
1783930018,REC201,23,52,7.5,75
1783930018,RAS251,47,44,7.5,91
1783930018,REE251,47,48,7.5,95
1783930018,RAS254,49,47,7.5,96
1783930018,RME252,46,41,7.5,87
1783930018,RAS301,23,52,9.0,75
1783930018,RVE301,28,52,9.0,80
1783930018,REE305,28,65,9.0,93
1783930018,REC301,29,54,9.0,83
1783930018,REC302,24,60,9.0,84
1783930018,REC303,20,60,9.0,80
1783930018,REC351,45,46,9.0,91
1783930018,REC352,40,42,9.0,82
1783930018,REC353,39,41,9.0,80
1783930018,REC354,43,45,9.0,88
1783930018,ROE047,29,49,7.96,78
1783930018,RAS402,25,55,7.96,80
1783930018,REC401,26,45,7.96,71
1783930018,REC402,21,41,7.96,62
1783930018,REC403,20,44,7.96,64
1783930018,RCS406,23,40,7.96,63
1783930018,REC451,45,47,7.96,92
1783930018,REC452,46,48,7.96,94
1783930018,REC453,40,45,7.96,85
1783930018,RCS456,44,44,7.96,88
1783930018,RAS501,30,55,8.29,85
1783930018,RAS502,29,61,8.29,90
1783930018,REC501A,21,41,8.29,62
1783930018,REC502,21,47,8.29,68
1783930018,REC503,16,64,8.29,80
1783930018,REC051,24,50,8.29,74
1783930018,REC551,42,36,8.29,78
1783930018,REC552,48,42,8.29,90
1783930018,REC553,37,41,8.29,78
1783930018,REC554,41,35,8.29,76
1783930018,RAS601,29,55,8.46,84
1783930018,RUC601,28,55,8.46,83
1783930018,RIC603,19,48,8.46,67
1783930018,REC601,27,54,8.46,81
1783930018,REC602,27,54,8.46,81
1783930018,REC064,18,48,8.46,66
1783930018,REC651,44,44,8.46,88
1783930018,REC652,48,45,8.46,93
1783930018,RIC653,41,43,8.46,84
1783930018,RIC651,42,44,8.46,86
1783930018,ROE072,29,55,8.63,84
1783930018,REC072,29,43,8.63,72
1783930018,REC075,29,46,8.63,75
1783930018,REC701,30,47,8.63,77
1783930018,REC702,28,52,8.63,80
1783930018,REC751,48,48,8.63,96
1783930018,REC752,42,48,8.63,90
1783930018,REC753,88,0,8.63,88
1783930018,REC754,160,0,8.63,160
1783930019,RAS101,20,51,7.92,71
1783930019,RAS102,19,41,7.92,60
1783930019,RAS103,26,51,7.92,77
1783930019,RME101,25,53,7.92,78
1783930019,RCS101,23,46,7.92,69
1783930019,RAS152,40,42,7.92,82
1783930019,RME151,45,44,7.92,89
1783930019,RCS151,43,40,7.92,83
1783930019,RCE151,42,40,7.92,82
1783930019,RAS203,25,26,7.17,51
1783930019,RAS201,21,31,7.17,52
1783930019,REE201,26,43,7.17,69
1783930019,RAS204,24,36,7.17,60
1783930019,REC201,24,36,7.17,60
1783930019,RAS251,48,48,7.17,96
1783930019,REE251,48,47,7.17,95
1783930019,RAS254,45,42,7.17,87
1783930019,RME252,46,40,7.17,86
1783930019,RAS301,21,52,7.54,73
1783930019,RVE301,18,41,7.54,59
1783930019,REE305,29,46,7.54,75
1783930019,REC301,23,42,7.54,65
1783930019,REC302,21,33,7.54,54
1783930019,REC303,26,63,7.54,89
1783930019,REC351,45,40,7.54,85
1783930019,REC352,38,38,7.54,76
1783930019,REC353,39,47,7.54,86
1783930019,REC354,44,43,7.54,87
1783930019,ROE047,28,30,7.63,58
1783930019,RAS402,24,48,7.63,72
1783930019,REC401,25,47,7.63,72
1783930019,REC402,26,48,7.63,74
1783930019,REC403,29,39,7.63,68
1783930019,RCS406,25,35,7.63,60
1783930019,REC451,42,37,7.63,79
1783930019,REC452,47,49,7.63,96
1783930019,REC453,47,49,7.63,96
1783930019,RCS456,44,42,7.63,86
1783930019,RAS501,25,46,7.79,71
1783930019,RAS502,24,45,7.79,69
1783930019,REC501A,27,43,7.79,70
1783930019,REC502,23,41,7.79,64
1783930019,REC503,25,56,7.79,81
1783930019,REC051,23,43,7.79,66
1783930019,REC551,42,42,7.79,84
1783930019,REC552,45,41,7.79,86
1783930019,REC553,44,40,7.79,84
1783930019,REC554,41,38,7.79,79
1783930019,RAS601,29,51,8.21,80
1783930019,RUC601,27,50,8.21,77
1783930019,RIC603,17,43,8.21,60
1783930019,REC601,25,49,8.21,74
1783930019,REC602,23,47,8.21,70
1783930019,REC064,27,50,8.21,77
1783930019,REC651,44,43,8.21,87
1783930019,REC652,47,44,8.21,91
1783930019,RIC653,40,42,8.21,82
1783930019,RIC651,40,42,8.21,82
1783930019,ROE072,26,35,7.83,61
1783930019,REC072,28,46,7.83,74
1783930019,REC075,28,36,7.83,64
1783930019,REC701,24,34,7.83,58
1783930019,REC702,28,52,7.83,80
1783930019,REC751,44,46,7.83,90
1783930019,REC752,40,46,7.83,86
1783930019,REC753,80,0,7.83,80
1783930019,REC754,160,0,7.83,160
1783930020,RAS101,20,51,6.5,71
1783930020,RAS102,20,23,6.5,43
1783930020,RAS103,21,27,6.5,48
1783930020,RME101,22,47,6.5,69
1783930020,RCS101,20,25,6.5,45
1783930020,RAS152,41,41,6.5,82
1783930020,RME151,42,45,6.5,87
1783930020,RCS151,40,40,6.5,80
1783930020,RCE151,42,39,6.5,81
1783930020,RAS203,15,56,6.58,71
1783930020,RAS201,15,40,6.58,55
1783930020,REE201,19,26,6.58,45
1783930020,RAS204,21,32,6.58,53
1783930020,REC201,16,31,6.58,47
1783930020,RAS251,40,45,6.58,85
1783930020,REE251,48,45,6.58,93
1783930020,RAS254,40,47,6.58,87
1783930020,RME252,38,40,6.58,78
1783930020,RAS301,15,28,5.58,43
1783930020,RVE301,20,29,5.58,49
1783930020,REE305,21,32,5.58,53
1783930020,REC301,17,25,5.58,42
1783930020,REC302,17,39,5.58,56
1783930020,REC303,15,39,5.58,54
1783930020,REC351,38,37,5.58,75
1783930020,REC352,34,33,5.58,67
1783930020,REC353,38,35,5.58,73
1783930020,REC354,38,37,5.58,75
1783930020,ROE047,18,35,5.79,53
1783930020,RAS402,16,32,5.79,48
1783930020,REC401,15,24,5.79,39
1783930020,REC402,12,38,5.79,50
1783930020,REC403,16,44,5.79,60
1783930020,RCS406,12,49,5.79,61
1783930020,REC451,39,35,5.79,74
1783930020,REC452,36,39,5.79,75
1783930020,REC453,42,44,5.79,86
1783930020,RCS456,41,43,5.79,84
1783930020,RAS501,25,37,5.46,62
1783930020,RAS502,23,19,5.46,42
1783930020,REC501A,14,30,5.46,44
1783930020,REC502,18,34,5.46,52
1783930020,REC503,10,40,5.46,50
1783930020,REC051,14,45,5.46,59
1783930020,REC551,33,40,5.46,73
1783930020,REC552,45,42,5.46,87
1783930020,REC553,37,41,5.46,78
1783930020,REC554,32,35,5.46,67
1783930020,RAS601,28,45,7.0,73
1783930020,RUC601,25,43,7.0,68
1783930020,RIC603,17,37,7.0,54
1783930020,REC601,19,38,7.0,57
1783930020,REC602,25,43,7.0,68
1783930020,REC064,18,38,7.0,56
1783930020,REC651,45,43,7.0,88
1783930020,REC652,47,43,7.0,90
1783930020,RIC653,39,41,7.0,80
1783930020,RIC651,35,40,7.0,75
1783930020,ROE072,26,32,6.96,58
1783930020,REC072,24,34,6.96,58
1783930020,REC075,24,37,6.96,61
1783930020,REC701,18,35,6.96,53
1783930020,REC702,24,30,6.96,54
1783930020,REC751,42,44,6.96,86
1783930020,REC752,39,44,6.96,83
1783930020,REC753,75,0,6.96,75
1783930020,REC754,160,0,6.96,160
1783930021,RAS101,22,28,6.25,50
1783930021,RAS102,20,22,6.25,42
1783930021,RAS103,22,25,6.25,47
1783930021,RME101,23,27,6.25,50
1783930021,RCS101,22,47,6.25,69
1783930021,RAS152,40,42,6.25,82
1783930021,RME151,43,44,6.25,87
1783930021,RCS151,42,43,6.25,85
1783930021,RCE151,44,40,6.25,84
1783930021,RAS203,15,31,6.5,46
1783930021,RAS201,15,30,6.5,45
1783930021,REE201,22,32,6.5,54
1783930021,RAS204,25,43,6.5,68
1783930021,REC201,18,36,6.5,54
1783930021,RAS251,40,46,6.5,86
1783930021,REE251,44,46,6.5,90
1783930021,RAS254,45,45,6.5,90
1783930021,RME252,44,39,6.5,83
1783930021,RAS301,16,27,5.08,43
1783930021,RVE301,14,21,5.08,35
1783930021,REE305,22,43,5.08,65
1783930021,REC301,23,28,5.08,51
1783930021,REC302,20,28,5.08,48
1783930021,REC303,19,21,5.08,40
1783930021,REC351,43,43,5.08,86
1783930021,REC352,40,39,5.08,79
1783930021,REC353,39,41,5.08,80
1783930021,REC354,45,41,5.08,86
1783930021,ROE047,20,21,5.67,41
1783930021,RAS402,15,44,5.67,59
1783930021,REC401,17,23,5.67,40
1783930021,REC402,16,32,5.67,48
1783930021,REC403,17,38,5.67,55
1783930021,RCS406,14,45,5.67,59
1783930021,REC451,39,35,5.67,74
1783930021,REC452,40,44,5.67,84
1783930021,REC453,42,44,5.67,86
1783930021,RCS456,41,37,5.67,78
1783930021,RAS501,25,36,6.38,61
1783930021,RAS502,23,29,6.38,52
1783930021,REC501A,16,45,6.38,61
1783930021,REC502,20,35,6.38,55
1783930021,REC503,15,31,6.38,46
1783930021,REC051,19,26,6.38,45
1783930021,REC551,43,45,6.38,88
1783930021,REC552,40,38,6.38,78
1783930021,REC553,37,37,6.38,74
1783930021,REC554,42,47,6.38,89
1783930021,RAS601,28,42,7.29,70
1783930021,RUC601,23,38,7.29,61
1783930021,RIC603,21,37,7.29,58
1783930021,REC601,23,38,7.29,61
1783930021,REC602,24,39,7.29,63
1783930021,REC064,18,35,7.29,53
1783930021,REC651,47,43,7.29,90
1783930021,REC652,47,43,7.29,90
1783930021,RIC653,40,41,7.29,81
1783930021,RIC651,47,43,7.29,90
1783930021,ROE072,24,38,7.38,62
1783930021,REC072,22,36,7.38,58
1783930021,REC075,23,35,7.38,58
1783930021,REC701,25,53,7.38,78
1783930021,REC702,23,50,7.38,73
1783930021,REC751,41,46,7.38,87
1783930021,REC752,41,46,7.38,87
1783930021,REC753,76,0,7.38,76
1783930021,REC754,155,0,7.38,155
1783930022,RAS101,15,1,3.92,16
1783930022,RAS102,19,16,3.92,35
1783930022,RAS103,21,23,3.92,44
1783930022,RME101,19,24,3.92,43
1783930022,RCS101,24,28,3.92,52
1783930022,RAS152,40,38,3.92,78
1783930022,RME151,40,43,3.92,83
1783930022,RCS151,44,42,3.92,86
1783930022,RCE151,45,41,3.92,86
1783930022,RAS203,15,31,5.54,46
1783930022,RAS201,15,14,5.54,29
1783930022,REE201,20,45,5.54,65
1783930022,RAS204,21,28,5.54,49
1783930022,REC201,14,38,5.54,52
1783930022,RAS251,38,44,5.54,82
1783930022,REE251,44,47,5.54,91
1783930022,RAS254,45,40,5.54,85
1783930022,RME252,43,38,5.54,81
1783930022,RAS301,14,27,5.08,41
1783930022,RVE301,18,28,5.08,46
1783930022,REE305,18,40,5.08,58
1783930022,REC301,13,17,5.08,30
1783930022,REC302,15,39,5.08,54
1783930022,REC303,14,44,5.08,58
1783930022,REC351,38,39,5.08,77
1783930022,REC352,36,36,5.08,72
1783930022,REC353,35,35,5.08,70
1783930022,REC354,35,33,5.08,68
1783930022,ROE047,20,42,5.33,62
1783930022,RAS402,18,38,5.33,56
1783930022,REC401,16,33,5.33,49
1783930022,REC402,12,23,5.33,35
1783930022,REC403,15,43,5.33,58
1783930022,RCS406,9,45,5.33,54
1783930022,REC451,37,37,5.33,74
1783930022,REC452,32,35,5.33,67
1783930022,REC453,39,40,5.33,79
1783930022,RCS456,41,38,5.33,79
1783930022,RAS501,23,46,5.04,69
1783930022,RAS502,25,44,5.04,69
1783930022,REC501A,11,22,5.04,33
1783930022,REC502,15,35,5.04,50
1783930022,REC503,10,4,5.04,14
1783930022,REC051,14,39,5.04,53
1783930022,REC551,33,36,5.04,69
1783930022,REC552,38,38,5.04,76
1783930022,REC553,37,37,5.04,74
1783930022,REC554,32,38,5.04,70
1783930022,RAS601,27,39,6.5,66
1783930022,RUC601,25,38,6.5,63
1783930022,RIC603,16,31,6.5,47
1783930022,REC601,19,33,6.5,52
1783930022,REC602,22,35,6.5,57
1783930022,REC064,18,33,6.5,51
1783930022,REC651,40,39,6.5,79
1783930022,REC652,44,40,6.5,84
1783930022,RIC653,38,38,6.5,76
1783930022,RIC651,38,38,6.5,76
1783930023,RAS101,15,53,6.25,68
1783930023,RAS102,20,22,6.25,42
1783930023,RAS103,21,37,6.25,58
1783930023,RME101,23,23,6.25,46
1783930023,RCS101,19,34,6.25,53
1783930023,RAS152,40,38,6.25,78
1783930023,RME151,43,42,6.25,85
1783930023,RCS151,49,40,6.25,89
1783930023,RCE151,42,39,6.25,81
1783930023,RAS203,15,30,5.88,45
1783930023,RAS201,17,40,5.88,57
1783930023,REE201,20,33,5.88,53
1783930023,RAS204,21,28,5.88,49
1783930023,REC201,15,43,5.88,58
1783930023,RAS251,43,45,5.88,88
1783930023,RME251,0,0,5.88,0
1783930023,RAS254,40,40,5.88,80
1783930023,RME252,40,35,5.88,75
1783930023,RAS301,20,28,5.58,48
1783930023,RVE301,16,41,5.58,57
1783930023,REE305,24,53,5.58,77
1783930023,REC301,22,9,5.58,31
1783930023,REC302,18,25,5.58,43
1783930023,REC303,19,53,5.58,72
1783930023,REC351,36,40,5.58,76
1783930023,REC352,44,34,5.58,78
1783930023,REC353,42,41,5.58,83
1783930023,REC354,28,35,5.58,63
1783930023,ROE047,18,35,6.29,53
1783930023,RAS402,17,27,6.29,44
1783930023,REC401,18,42,6.29,60
1783930023,REC402,18,44,6.29,62
1783930023,REC403,15,35,6.29,50
1783930023,RCS406,12,35,6.29,47
1783930023,REC451,35,35,6.29,70
1783930023,REC452,33,46,6.29,79
1783930023,REC453,36,39,6.29,75
1783930023,RCS456,41,39,6.29,80
1783930023,RAS501,23,35,6.13,58
1783930023,RAS502,22,24,6.13,46
1783930023,REC501A,16,37,6.13,53
1783930023,REC502,18,27,6.13,45
1783930023,REC503,16,32,6.13,48
1783930023,REC051,17,43,6.13,60
1783930023,REC551,36,40,6.13,76
1783930023,REC552,40,41,6.13,81
1783930023,REC553,39,40,6.13,79
1783930023,REC554,35,38,6.13,73
1783930023,RAS601,28,43,6.79,71
1783930023,RUC601,25,41,6.79,66
1783930023,RIC603,15,34,6.79,49
1783930023,REC601,21,38,6.79,59
1783930023,REC602,25,41,6.79,66
1783930023,REC064,18,36,6.79,54
1783930023,REC651,43,40,6.79,83
1783930023,REC652,46,41,6.79,87
1783930023,RIC653,34,37,6.79,71
1783930023,RIC651,35,38,6.79,73
1783930023,ROE072,22,27,7.08,49
1783930023,REC072,28,23,7.08,51
1783930023,REC075,28,46,7.08,74
1783930023,REC701,21,41,7.08,62
1783930023,REC702,24,25,7.08,49
1783930023,REC751,46,44,7.08,90
1783930023,REC752,45,44,7.08,89
1783930023,REC753,78,0,7.08,78
1783930023,REC754,165,0,7.08,165
1783930024,RAS101,23,38,8.0,61
1783930024,RAS102,24,37,8.0,61
1783930024,RAS103,26,59,8.0,85
1783930024,RME101,27,41,8.0,68
1783930024,RCS101,27,51,8.0,78
1783930024,RAS152,48,48,8.0,96
1783930024,RME151,46,48,8.0,94
1783930024,RCS151,47,44,8.0,91
1783930024,RCE151,39,42,8.0,81
1783930024,RAS203,23,42,7.71,65
1783930024,RAS201,23,52,7.71,75
1783930024,REE201,29,45,7.71,74
1783930024,RAS204,21,37,7.71,58
1783930024,REC201,24,37,7.71,61
1783930024,RAS251,45,46,7.71,91
1783930024,REE251,48,46,7.71,94
1783930024,RAS254,40,45,7.71,85
1783930024,RME252,44,45,7.71,89
1783930024,RAS301,22,56,7.63,78
1783930024,RVE301,22,28,7.63,50
1783930024,REE305,27,52,7.63,79
1783930024,REC301,29,46,7.63,75
1783930024,REC302,20,44,7.63,64
1783930024,REC303,24,43,7.63,67
1783930024,REC351,42,48,7.63,90
1783930024,REC352,36,35,7.63,71
1783930024,REC353,39,45,7.63,84
1783930024,REC354,42,45,7.63,87
1783930024,ROE047,27,51,7.63,78
1783930024,RAS402,25,28,7.63,53
1783930024,REC401,23,47,7.63,70
1783930024,REC402,20,48,7.63,68
1783930024,REC403,24,53,7.63,77
1783930024,RCS406,24,47,7.63,71
1783930024,REC451,38,37,7.63,75
1783930024,REC452,34,38,7.63,72
1783930024,REC453,36,38,7.63,74
1783930024,RCS456,44,44,7.63,88
1783930024,RAS501,26,42,7.42,68
1783930024,RAS502,25,44,7.42,69
1783930024,REC501A,20,46,7.42,66
1783930024,REC502,23,29,7.42,52
1783930024,REC503,27,56,7.42,83
1783930024,REC051,22,47,7.42,69
1783930024,REC551,37,47,7.42,84
1783930024,REC552,45,43,7.42,88
1783930024,REC553,44,42,7.42,86
1783930024,REC554,36,47,7.42,83
1783930024,RAS601,28,52,7.83,80
1783930024,RUC601,25,50,7.83,75
1783930024,RIC603,15,43,7.83,58
1783930024,REC601,25,50,7.83,75
1783930024,REC602,25,50,7.83,75
1783930024,REC064,18,45,7.83,63
1783930024,REC651,44,44,7.83,88
1783930024,REC652,47,45,7.83,92
1783930024,RIC653,37,42,7.83,79
1783930024,RIC651,34,41,7.83,75
1783930024,ROE072,25,47,8.08,72
1783930024,REC072,26,44,8.08,70
1783930024,REC075,26,47,8.08,73
1783930024,REC701,23,50,8.08,73
1783930024,REC702,26,41,8.08,67
1783930024,REC751,42,46,8.08,88
1783930024,REC752,42,46,8.08,88
1783930024,REC753,79,0,8.08,79
1783930024,REC754,160,0,8.08,160
1783930025,RAS101,18,28,6.17,46
1783930025,RAS102,19,44,6.17,63
1783930025,RAS103,20,23,6.17,43
1783930025,RME101,17,28,6.17,45
1783930025,RCS101,22,44,6.17,66
1783930025,RAS152,40,40,6.17,80
1783930025,RME151,40,47,6.17,87
1783930025,RCS151,42,41,6.17,83
1783930025,RCE151,40,39,6.17,79
1783930025,RAS203,15,7,4.33,22
1783930025,RAS201,15,23,4.33,38
1783930025,REE201,19,41,4.33,60
1783930025,RAS204,21,23,4.33,44
1783930025,REC201,9,37,4.33,46
1783930025,RAS251,38,45,4.33,83
1783930025,REE251,46,46,4.33,92
1783930025,RAS254,45,38,4.33,83
1783930025,RME252,40,38,4.33,78
1783930025,RAS301,12,32,5.08,44
1783930025,RVE301,15,32,5.08,47
1783930025,REE305,24,36,5.08,60
1783930025,REC301,13,9,5.08,22
1783930025,REC302,15,32,5.08,47
1783930025,REC303,13,37,5.08,50
1783930025,REC351,41,39,5.08,80
1783930025,REC352,40,34,5.08,74
1783930025,REC353,35,35,5.08,70
1783930025,REC354,32,31,5.08,63
1783930025,ROE047,20,39,4.42,59
1783930025,RAS402,17,32,4.42,49
1783930025,REC401,15,41,4.42,56
1783930025,REC402,11,0,4.42,11
1783930025,REC403,14,37,4.42,51
1783930025,RCS406,9,25,4.42,34
1783930025,REC451,38,35,4.42,73
1783930025,REC452,34,38,4.42,72
1783930025,REC453,33,36,4.42,69
1783930025,RCS456,41,37,4.42,78
1783930025,RAS501,25,36,4.54,61
1783930025,RAS502,22,41,4.54,63
1783930025,REC501A,17,22,4.54,39
1783930025,REC502,16,21,4.54,37
1783930025,REC503,13,32,4.54,45
1783930025,REC051,19,28,4.54,47
1783930025,REC551,31,40,4.54,71
1783930025,REC552,40,38,4.54,78
1783930025,REC553,35,37,4.54,72
1783930025,REC554,30,40,4.54,70
1783930025,RAS601,26,40,6.46,66
1783930025,RUC601,19,35,6.46,54
1783930025,RIC603,15,33,6.46,48
1783930025,REC601,19,35,6.46,54
1783930025,REC602,28,42,6.46,70
1783930025,REC064,15,33,6.46,48
1783930025,REC651,44,40,6.46,84
1783930025,REC652,38,38,6.46,76
1783930025,RIC653,33,37,6.46,70
1783930025,RIC651,33,37,6.46,70
1783930025,ROE072,24,44,6.71,68
1783930025,REC072,18,30,6.71,48
1783930025,REC075,19,34,6.71,53
1783930025,REC701,15,41,6.71,56
1783930025,REC702,19,39,6.71,58
1783930025,REC751,36,40,6.71,76
1783930025,REC752,32,42,6.71,74
1783930025,REC753,76,0,6.71,76
1783930025,REC754,160,0,6.71,160
1783930026,RAS101,25,34,7.83,59
1783930026,RAS102,23,44,7.83,67
1783930026,RAS103,25,47,7.83,72
1783930026,RME101,26,56,7.83,82
1783930026,RCS101,24,45,7.83,69
1783930026,RAS152,46,44,7.83,90
1783930026,RME151,46,44,7.83,90
1783930026,RCS151,44,42,7.83,86
1783930026,RCE151,42,39,7.83,81
1783930026,RAS203,23,42,7.96,65
1783930026,RAS201,23,47,7.96,70
1783930026,REE201,23,50,7.96,73
1783930026,RAS204,23,44,7.96,67
1783930026,REC201,23,49,7.96,72
1783930026,RAS251,45,44,7.96,89
1783930026,REE251,45,47,7.96,92
1783930026,RAS254,40,45,7.96,85
1783930026,RME252,44,44,7.96,88
1783930026,RAS301,22,47,8.13,69
1783930026,RVE301,21,68,8.13,89
1783930026,REE305,26,49,8.13,75
1783930026,REC301,26,43,8.13,69
1783930026,REC302,20,51,8.13,71
1783930026,REC303,24,58,8.13,82
1783930026,REC351,40,45,8.13,85
1783930026,REC352,42,36,8.13,78
1783930026,REC353,49,46,8.13,95
1783930026,REC354,40,41,8.13,81
1783930026,ROE047,29,48,8.29,77
1783930026,RAS402,22,49,8.29,71
1783930026,REC401,27,31,8.29,58
1783930026,REC402,24,56,8.29,80
1783930026,REC403,28,48,8.29,76
1783930026,RCS406,29,53,8.29,82
1783930026,REC451,41,42,8.29,83
1783930026,REC452,46,48,8.29,94
1783930026,REC453,43,45,8.29,88
1783930026,RCS456,50,42,8.29,92
1783930026,RAS501,28,41,8.13,69
1783930026,RAS502,27,47,8.13,74
1783930026,REC501A,28,49,8.13,77
1783930026,REC502,30,41,8.13,71
1783930026,REC503,23,56,8.13,79
1783930026,REC051,28,44,8.13,72
1783930026,REC551,46,42,8.13,88
1783930026,REC552,48,45,8.13,93
1783930026,REC553,44,44,8.13,88
1783930026,REC554,45,45,8.13,90
1783930026,RAS601,28,54,8.71,82
1783930026,RUC601,23,50,8.71,73
1783930026,RIC603,26,52,8.71,78
1783930026,REC601,27,53,8.71,80
1783930026,REC602,29,54,8.71,83
1783930026,REC064,21,49,8.71,70
1783930026,REC651,44,44,8.71,88
1783930026,REC652,46,45,8.71,91
1783930026,RIC653,47,45,8.71,92
1783930026,RIC651,45,45,8.71,90
1783930026,ROE072,27,31,7.83,58
1783930026,REC072,29,48,7.83,77
1783930026,REC075,28,62,7.83,90
1783930026,REC701,25,34,7.83,59
1783930026,REC702,28,38,7.83,66
1783930026,REC751,48,40,7.83,88
1783930026,REC752,42,42,7.83,84
1783930026,REC753,78,0,7.83,78
1783930026,REC754,160,0,7.83,160
1783930027,RAS101,19,53,7.58,72
1783930027,RAS102,19,50,7.58,69
1783930027,RAS103,22,52,7.58,74
1783930027,RME101,22,35,7.58,57
1783930027,RCS101,20,45,7.58,65
1783930027,RAS152,41,39,7.58,80
1783930027,RME151,42,47,7.58,89
1783930027,RCS151,40,44,7.58,84
1783930027,RCE151,44,40,7.58,84
1783930027,RAS203,17,39,7.71,56
1783930027,RAS201,20,50,7.71,70
1783930027,REE201,26,52,7.71,78
1783930027,RAS204,23,27,7.71,50
1783930027,REC201,24,51,7.71,75
1783930027,RAS251,44,45,7.71,89
1783930027,REE251,46,48,7.71,94
1783930027,RAS254,45,45,7.71,90
1783930027,RME252,40,45,7.71,85
1783930027,RAS301,22,38,7.5,60
1783930027,RVE301,23,54,7.5,77
1783930027,REE305,27,43,7.5,70
1783930027,REC301,26,31,7.5,57
1783930027,REC302,22,30,7.5,52
1783930027,REC303,22,51,7.5,73
1783930027,REC351,47,49,7.5,96
1783930027,REC352,42,40,7.5,82
1783930027,REC353,39,42,7.5,81
1783930027,REC354,45,47,7.5,92
1783930027,ROE047,26,49,7.38,75
1783930027,RAS402,22,46,7.38,68
1783930027,REC401,22,33,7.38,55
1783930027,REC402,19,44,7.38,63
1783930027,REC403,22,44,7.38,66
1783930027,RCS406,24,37,7.38,61
1783930027,REC451,43,40,7.38,83
1783930027,REC452,43,46,7.38,89
1783930027,REC453,42,45,7.38,87
1783930027,RCS456,41,41,7.38,82
1783930027,RAS501,30,45,7.38,75
1783930027,RAS502,21,42,7.38,63
1783930027,REC501A,20,47,7.38,67
1783930027,REC502,29,35,7.38,64
1783930027,REC503,23,40,7.38,63
1783930027,REC051,24,33,7.38,57
1783930027,REC551,39,47,7.38,86
1783930027,REC552,48,46,7.38,94
1783930027,REC553,44,47,7.38,91
1783930027,REC554,38,45,7.38,83
1783930027,RAS601,28,50,7.79,78
1783930027,RUC601,23,46,7.79,69
1783930027,RIC603,26,48,7.79,74
1783930027,REC601,19,43,7.79,62
1783930027,REC602,25,48,7.79,73
1783930027,REC064,21,45,7.79,66
1783930027,REC651,44,45,7.79,89
1783930027,REC652,47,46,7.79,93
1783930027,RIC653,46,46,7.79,92
1783930027,RIC651,38,43,7.79,81
1783930027,ROE072,27,39,7.5,66
1783930027,REC072,28,41,7.5,69
1783930027,REC075,26,51,7.5,77
1783930027,REC701,26,26,7.5,52
1783930027,REC702,26,40,7.5,66
1783930027,REC751,48,48,7.5,96
1783930027,REC752,38,48,7.5,86
1783930027,REC753,80,0,7.5,80
1783930027,REC754,150,0,7.5,150
1783930028,RAS101,20,29,5.88,49
1783930028,RAS102,19,37,5.88,56
1783930028,RAS103,25,21,5.88,46
1783930028,RME101,22,23,5.88,45
1783930028,RCS101,22,21,5.88,43
1783930028,RAS152,42,40,5.88,82
1783930028,RME151,42,46,5.88,88
1783930028,RCS151,42,46,5.88,88
1783930028,RCE151,45,40,5.88,85
1783930028,RAS203,15,26,6.25,41
1783930028,RAS201,19,33,6.25,52
1783930028,REE201,19,33,6.25,52
1783930028,RAS204,27,36,6.25,63
1783930028,REC201,19,21,6.25,40
1783930028,RAS251,42,46,6.25,88
1783930028,REE251,48,49,6.25,97
1783930028,RAS254,45,45,6.25,90
1783930028,RME252,48,44,6.25,92
1783930028,RAS301,18,30,6.46,48
1783930028,RVE301,18,44,6.46,62
1783930028,REE305,25,39,6.46,64
1783930028,REC301,24,22,6.46,46
1783930028,REC302,20,30,6.46,50
1783930028,REC303,17,41,6.46,58
1783930028,REC351,43,48,6.46,91
1783930028,REC352,44,41,6.46,85
1783930028,REC353,39,37,6.46,76
1783930028,REC354,42,47,6.46,89
1783930028,ROE047,27,25,6.92,52
1783930028,RAS402,23,35,6.92,58
1783930028,REC401,24,28,6.92,52
1783930028,REC402,18,48,6.92,66
1783930028,REC403,21,39,6.92,60
1783930028,RCS406,22,38,6.92,60
1783930028,REC451,42,42,6.92,84
1783930028,REC452,47,49,6.92,96
1783930028,REC453,41,42,6.92,83
1783930028,RCS456,41,37,6.92,78
1783930028,RAS501,30,46,5.71,76
1783930028,RAS502,23,47,5.71,70
1783930028,REC501A,16,29,5.71,45
1783930028,REC502,18,22,5.71,40
1783930028,REC503,14,25,5.71,39
1783930028,REC051,19,28,5.71,47
1783930028,REC551,43,47,5.71,90
1783930028,REC552,48,45,5.71,93
1783930028,REC553,37,45,5.71,82
1783930028,REC554,42,42,5.71,84
1783930028,RAS601,28,42,7.5,70
1783930028,RUC601,26,40,7.5,66
1783930028,RIC603,26,40,7.5,66
1783930028,REC601,23,38,7.5,61
1783930028,REC602,28,42,7.5,70
1783930028,REC064,18,35,7.5,53
1783930028,REC651,44,44,7.5,88
1783930028,REC652,48,45,7.5,93
1783930028,RIC653,45,45,7.5,90
1783930028,RIC651,38,42,7.5,80
1783930028,ROE072,26,31,7.21,57
1783930028,REC072,29,38,7.21,67
1783930028,REC075,27,53,7.21,80
1783930028,REC701,26,29,7.21,55
1783930028,REC702,27,21,7.21,48
1783930028,REC751,47,48,7.21,95
1783930028,REC752,38,48,7.21,86
1783930028,REC753,78,0,7.21,78
1783930028,REC754,150,0,7.21,150
1783930029,RAS101,18,24,6.17,42
1783930029,RAS102,19,31,6.17,50
1783930029,RAS103,23,39,6.17,62
1783930029,RME101,17,28,6.17,45
1783930029,RCS101,22,26,6.17,48
1783930029,RAS152,42,40,6.17,82
1783930029,RME151,40,44,6.17,84
1783930029,RCS151,42,41,6.17,83
1783930029,RCE151,44,42,6.17,86
1783930029,RAS203,18,36,6.38,54
1783930029,RAS201,15,53,6.38,68
1783930029,REE201,22,35,6.38,57
1783930029,RAS204,19,29,6.38,48
1783930029,REC201,19,22,6.38,41
1783930029,RAS251,40,47,6.38,87
1783930029,REE251,44,47,6.38,91
1783930029,RAS254,46,40,6.38,86
1783930029,RME252,42,40,6.38,82
1783930029,RAS301,15,35,6.04,50
1783930029,RVE301,14,34,6.04,48
1783930029,REE305,25,43,6.04,68
1783930029,REC301,23,26,6.04,49
1783930029,REC302,18,29,6.04,47
1783930029,REC303,17,36,6.04,53
1783930029,REC351,40,38,6.04,78
1783930029,REC352,34,41,6.04,75
1783930029,REC353,39,38,6.04,77
1783930029,REC354,35,37,6.04,72
1783930029,ROE047,22,37,5.5,59
1783930029,RAS402,20,21,5.5,41
1783930029,REC401,17,23,5.5,40
1783930029,REC402,19,28,5.5,47
1783930029,REC403,16,34,5.5,50
1783930029,RCS406,20,21,5.5,41
1783930029,REC451,40,35,5.5,75
1783930029,REC452,38,41,5.5,79
1783930029,REC453,41,44,5.5,85
1783930029,RCS456,44,38,5.5,82
1783930029,RAS501,23,35,6.08,58
1783930029,RAS502,25,32,6.08,57
1783930029,REC501A,15,28,6.08,43
1783930029,REC502,18,36,6.08,54
1783930029,REC503,12,39,6.08,51
1783930029,REC051,19,26,6.08,45
1783930029,REC551,44,47,6.08,91
1783930029,REC552,43,41,6.08,84
1783930029,REC553,37,40,6.08,77
1783930029,REC554,43,42,6.08,85
1783930029,RAS601,28,42,7.17,70
1783930029,RUC601,28,42,7.17,70
1783930029,RIC603,20,36,7.17,56
1783930029,REC601,23,38,7.17,61
1783930029,REC602,25,40,7.17,65
1783930029,REC064,16,33,7.17,49
1783930029,REC651,45,43,7.17,88
1783930029,REC652,46,43,7.17,89
1783930029,RIC653,41,41,7.17,82
1783930029,RIC651,48,43,7.17,91
1783930029,ROE072,25,37,7.08,62
1783930029,REC072,23,32,7.08,55
1783930029,REC075,24,38,7.08,62
1783930029,REC701,21,32,7.08,53
1783930029,REC702,24,31,7.08,55
1783930029,REC751,42,46,7.08,88
1783930029,REC752,42,46,7.08,88
1783930029,REC753,77,0,7.08,77
1783930029,REC754,160,0,7.08,160
1783930030,RAS101,22,48,8.5,70
1783930030,RAS102,27,45,8.5,72
1783930030,RAS103,30,69,8.5,99
1783930030,RME101,27,39,8.5,66
1783930030,RCS101,27,48,8.5,75
1783930030,RAS152,47,46,8.5,93
1783930030,RME151,46,47,8.5,93
1783930030,RCS151,47,45,8.5,92
1783930030,RCE151,45,39,8.5,84
1783930030,RAS203,28,40,8.13,68
1783930030,RAS201,22,56,8.13,78
1783930030,REE201,27,47,8.13,74
1783930030,RAS204,27,37,8.13,64
1783930030,REC201,28,47,8.13,75
1783930030,RAS251,44,46,8.13,90
1783930030,REE251,48,49,8.13,97
1783930030,RAS254,45,45,8.13,90
1783930030,RME252,49,47,8.13,96
1783930030,RAS301,27,39,7.63,66
1783930030,RVE301,25,38,7.63,63
1783930030,REE305,26,51,7.63,77
1783930030,REC301,27,47,7.63,74
1783930030,REC302,26,41,7.63,67
1783930030,REC303,28,40,7.63,68
1783930030,REC351,45,42,7.63,87
1783930030,REC352,46,39,7.63,85
1783930030,REC353,39,49,7.63,88
1783930030,REC354,47,48,7.63,95
1783930030,ROE047,30,36,8.13,66
1783930030,RAS402,26,45,8.13,71
1783930030,REC401,27,37,8.13,64
1783930030,REC402,28,51,8.13,79
1783930030,REC403,29,52,8.13,81
1783930030,RCS406,30,47,8.13,77
1783930030,REC451,45,47,8.13,92
1783930030,REC452,42,45,8.13,87
1783930030,REC453,45,48,8.13,93
1783930030,RCS456,47,43,8.13,90
1783930030,RAS501,29,53,8.88,82
1783930030,RAS502,28,50,8.88,78
1783930030,REC501A,28,52,8.88,80
1783930030,REC502,30,56,8.88,86
1783930030,REC503,29,56,8.88,85
1783930030,REC051,28,44,8.88,72
1783930030,REC551,46,47,8.88,93
1783930030,REC552,48,48,8.88,96
1783930030,REC553,48,48,8.88,96
1783930030,REC554,45,45,8.88,90
1783930030,RAS601,30,54,8.83,84
1783930030,RUC601,28,53,8.83,81
1783930030,RIC603,27,52,8.83,79
1783930030,REC601,29,53,8.83,82
1783930030,REC602,29,53,8.83,82
1783930030,REC064,25,51,8.83,76
1783930030,REC651,44,45,8.83,89
1783930030,REC652,46,46,8.83,92
1783930030,RIC653,48,46,8.83,94
1783930030,RIC651,48,46,8.83,94
1783930030,ROE072,29,32,8.13,61
1783930030,REC072,29,49,8.13,78
1783930030,REC075,29,48,8.13,77
1783930030,REC701,29,42,8.13,71
1783930030,REC702,29,37,8.13,66
1783930030,REC751,48,48,8.13,96
1783930030,REC752,43,48,8.13,91
1783930030,REC753,85,0,8.13,85
1783930030,REC754,175,0,8.13,175
1783930031,RAS101,18,45,7.04,63
1783930031,RAS102,19,26,7.04,45
1783930031,RAS103,24,32,7.04,56
1783930031,RME101,23,53,7.04,76
1783930031,RCS101,23,42,7.04,65
1783930031,RAS152,40,38,7.04,78
1783930031,RME151,43,43,7.04,86
1783930031,RCS151,43,45,7.04,88
1783930031,RCE151,46,40,7.04,86
1783930031,RAS203,23,33,6.46,56
1783930031,RAS201,20,41,6.46,61
1783930031,REE201,21,38,6.46,59
1783930031,RAS204,23,33,6.46,56
1783930031,REC201,21,23,6.46,44
1783930031,RAS251,43,45,6.46,88
1783930031,REE251,42,46,6.46,88
1783930031,RAS254,45,38,6.46,83
1783930031,RME252,46,38,6.46,84
1783930031,RAS301,19,27,6.96,46
1783930031,RVE301,23,29,6.96,52
1783930031,REE305,22,46,6.96,68
1783930031,REC301,27,34,6.96,61
1783930031,REC302,17,57,6.96,74
1783930031,REC303,23,45,6.96,68
1783930031,REC351,43,37,6.96,80
1783930031,REC352,38,34,6.96,72
1783930031,REC353,40,47,6.96,87
1783930031,REC354,40,35,6.96,75
1783930031,ROE047,28,21,6.5,49
1783930031,RAS402,21,42,6.5,63
1783930031,REC401,22,29,6.5,51
1783930031,REC402,17,45,6.5,62
1783930031,REC403,18,40,6.5,58
1783930031,RCS406,19,39,6.5,58
1783930031,REC451,41,37,6.5,78
1783930031,REC452,34,38,6.5,72
1783930031,REC453,44,45,6.5,89
1783930031,RCS456,41,37,6.5,78
1783930031,RAS501,26,45,7.0,71
1783930031,RAS502,23,49,7.0,72
1783930031,REC501A,18,43,7.0,61
1783930031,REC502,19,30,7.0,49
1783930031,REC503,19,42,7.0,61
1783930031,REC051,17,39,7.0,56
1783930031,REC551,43,36,7.0,79
1783930031,REC552,45,44,7.0,89
1783930031,REC553,38,44,7.0,82
1783930031,REC554,42,35,7.0,77
1783930031,RAS601,28,47,7.38,75
1783930031,RUC601,25,45,7.38,70
1783930031,RIC603,16,38,7.38,54
1783930031,REC601,23,43,7.38,66
1783930031,REC602,20,41,7.38,61
1783930031,REC064,23,43,7.38,66
1783930031,REC651,44,42,7.38,86
1783930031,REC652,41,41,7.38,82
1783930031,RIC653,34,39,7.38,73
1783930031,RIC651,34,39,7.38,73
1783930031,ROE072,24,27,7.04,51
1783930031,REC072,19,31,7.04,50
1783930031,REC075,21,53,7.04,74
1783930031,REC701,24,25,7.04,49
1783930031,REC702,21,40,7.04,61
1783930031,REC751,40,42,7.04,82
1783930031,REC752,36,42,7.04,78
1783930031,REC753,75,0,7.04,75
1783930031,REC754,175,0,7.04,175
1783930032,RAS101,18,53,7.75,71
1783930032,RAS102,27,43,7.75,70
1783930032,RAS103,25,36,7.75,61
1783930032,RME101,28,35,7.75,63
1783930032,RCS101,24,33,7.75,57
1783930032,RAS152,47,45,7.75,92
1783930032,RME151,47,44,7.75,91
1783930032,RCS151,44,47,7.75,91
1783930032,RCE151,45,39,7.75,84
1783930032,RAS203,18,37,7.38,55
1783930032,RAS201,18,40,7.38,58
1783930032,REE201,26,56,7.38,82
1783930032,RAS204,26,30,7.38,56
1783930032,REC201,24,40,7.38,64
1783930032,RAS251,42,47,7.38,89
1783930032,REE251,45,47,7.38,92
1783930032,RAS254,45,47,7.38,92
1783930032,RME252,44,43,7.38,87
1783930032,RAS301,23,54,7.54,77
1783930032,RVE301,17,50,7.54,67
1783930032,REE305,28,39,7.54,67
1783930032,REC301,27,47,7.54,74
1783930032,REC302,20,32,7.54,52
1783930032,REC303,24,43,7.54,67
1783930032,REC351,47,45,7.54,92
1783930032,REC352,42,39,7.54,81
1783930032,REC353,43,48,7.54,91
1783930032,REC354,44,41,7.54,85
1783930032,ROE047,27,45,8.0,72
1783930032,RAS402,23,49,8.0,72
1783930032,REC401,22,32,8.0,54
1783930032,REC402,22,44,8.0,66
1783930032,REC403,21,60,8.0,81
1783930032,RCS406,19,54,8.0,73
1783930032,REC451,44,45,8.0,89
1783930032,REC452,45,47,8.0,92
1783930032,REC453,47,49,8.0,96
1783930032,RCS456,44,47,8.0,91
1783930032,RAS501,28,52,8.17,80
1783930032,RAS502,25,43,8.17,68
1783930032,REC501A,23,56,8.17,79
1783930032,REC502,25,42,8.17,67
1783930032,REC503,26,41,8.17,67
1783930032,REC051,24,56,8.17,80
1783930032,REC551,45,42,8.17,87
1783930032,REC552,48,47,8.17,95
1783930032,REC553,47,46,8.17,93
1783930032,REC554,44,47,8.17,91
1783930032,RAS601,30,53,8.0,83
1783930032,RUC601,27,51,8.0,78
1783930032,RIC603,22,47,8.0,69
1783930032,REC601,25,50,8.0,75
1783930032,REC602,23,48,8.0,71
1783930032,REC064,22,47,8.0,69
1783930032,REC651,43,45,8.0,88
1783930032,REC652,44,45,8.0,89
1783930032,RIC653,44,45,8.0,89
1783930032,RIC651,37,43,8.0,80
1783930032,ROE072,28,39,8.17,67
1783930032,REC072,28,41,8.17,69
1783930032,REC075,28,52,8.17,80
1783930032,REC701,25,48,8.17,73
1783930032,REC702,28,44,8.17,72
1783930032,REC751,46,48,8.17,94
1783930032,REC752,42,48,8.17,90
1783930032,REC753,82,0,8.17,82
1783930032,REC754,155,0,8.17,155
1783930033,RAS101,20,42,7.25,62
1783930033,RAS102,19,39,7.25,58
1783930033,RAS103,22,43,7.25,65
1783930033,RME101,22,31,7.25,53
1783930033,RCS101,27,46,7.25,73
1783930033,RAS152,40,42,7.25,82
1783930033,RME151,42,45,7.25,87
1783930033,RCS151,47,46,7.25,93
1783930033,RCE151,44,40,7.25,84
1783930033,RAS203,25,42,7.29,67
1783930033,RAS201,22,39,7.29,61
1783930033,REE201,23,56,7.29,79
1783930033,RAS204,25,21,7.29,46
1783930033,REC201,25,28,7.29,53
1783930033,RAS251,44,46,7.29,90
1783930033,REE251,47,47,7.29,94
1783930033,RAS254,45,47,7.29,92
1783930033,RME252,46,41,7.29,87
1783930033,RAS301,21,44,7.33,65
1783930033,RVE301,15,52,7.33,67
1783930033,REE305,26,32,7.33,58
1783930033,REC301,24,45,7.33,69
1783930033,REC302,23,42,7.33,65
1783930033,REC303,23,51,7.33,74
1783930033,REC351,40,36,7.33,76
1783930033,REC352,44,44,7.33,88
1783930033,REC353,49,44,7.33,93
1783930033,REC354,40,45,7.33,85
1783930033,ROE047,26,32,6.79,58
1783930033,RAS402,20,40,6.79,60
1783930033,REC401,22,32,6.79,54
1783930033,REC402,20,32,6.79,52
1783930033,REC403,19,35,6.79,54
1783930033,RCS406,21,41,6.79,62
1783930033,REC451,43,37,6.79,80
1783930033,REC452,39,42,6.79,81
1783930033,REC453,47,49,6.79,96
1783930033,RCS456,41,43,6.79,84
1783930033,RAS501,27,38,7.04,65
1783930033,RAS502,22,41,7.04,63
1783930033,REC501A,19,31,7.04,50
1783930033,REC502,26,27,7.04,53
1783930033,REC503,16,49,7.04,65
1783930033,REC051,15,47,7.04,62
1783930033,REC551,41,47,7.04,88
1783930033,REC552,45,42,7.04,87
1783930033,REC553,40,41,7.04,81
1783930033,REC554,40,47,7.04,87
1783930033,RAS601,27,47,7.46,74
1783930033,RUC601,24,45,7.46,69
1783930033,RIC603,20,42,7.46,62
1783930033,REC601,19,41,7.46,60
1783930033,REC602,25,46,7.46,71
1783930033,REC064,16,39,7.46,55
1783930033,REC651,43,44,7.46,87
1783930033,REC652,47,45,7.46,92
1783930033,RIC653,39,43,7.46,82
1783930033,RIC651,38,42,7.46,80
1783930033,ROE072,25,35,7.58,60
1783930033,REC072,27,46,7.58,73
1783930033,REC075,26,41,7.58,67
1783930033,REC701,23,35,7.58,58
1783930033,REC702,26,35,7.58,61
1783930033,REC751,46,46,7.58,92
1783930033,REC752,40,46,7.58,86
1783930033,REC753,80,0,7.58,80
1783930033,REC754,165,0,7.58,165
1783930034,RAS101,20,49,7.21,69
1783930034,RAS102,29,24,7.21,53
1783930034,RAS103,26,53,7.21,79
1783930034,RME101,24,27,7.21,51
1783930034,RCS101,21,37,7.21,58
1783930034,RAS152,48,48,7.21,96
1783930034,RME151,44,47,7.21,91
1783930034,RCS151,41,40,7.21,81
1783930034,RCE151,45,39,7.21,84
1783930034,RAS203,24,33,7.13,57
1783930034,RAS201,24,41,7.13,65
1783930034,REE201,23,45,7.13,68
1783930034,RAS204,26,41,7.13,67
1783930034,REC201,22,34,7.13,56
1783930034,RAS251,46,46,7.13,92
1783930034,REE251,46,48,7.13,94
1783930034,RAS254,49,47,7.13,96
1783930034,RME252,38,37,7.13,75
1783930034,RAS301,21,43,6.88,64
1783930034,RVE301,20,38,6.88,58
1783930034,REE305,26,46,6.88,72
1783930034,REC301,20,27,6.88,47
1783930034,REC302,20,29,6.88,49
1783930034,REC303,30,41,6.88,71
1783930034,REC351,39,41,6.88,80
1783930034,REC352,42,36,6.88,78
1783930034,REC353,50,49,6.88,99
1783930034,REC354,39,41,6.88,80
1783930034,ROE047,24,44,6.29,68
1783930034,RAS402,21,36,6.29,57
1783930034,REC401,20,33,6.29,53
1783930034,REC402,22,50,6.29,72
1783930034,REC403,17,47,6.29,64
1783930034,RCS406,10,21,6.29,31
1783930034,REC451,44,35,6.29,79
1783930034,REC452,37,48,6.29,85
1783930034,REC453,38,40,6.29,78
1783930034,RCS456,47,38,6.29,85
1783930034,RAS501,25,43,7.71,68
1783930034,RAS502,22,62,7.71,84
1783930034,REC501A,23,31,7.71,54
1783930034,REC502,27,36,7.71,63
1783930034,REC503,24,62,7.71,86
1783930034,REC051,20,46,7.71,66
1783930034,REC551,41,47,7.71,88
1783930034,REC552,46,43,7.71,89
1783930034,REC553,42,43,7.71,85
1783930034,REC554,40,47,7.71,87
1783930034,RAS601,27,48,7.5,75
1783930034,RUC601,26,47,7.5,73
1783930034,RIC603,17,41,7.5,58
1783930034,REC601,21,44,7.5,65
1783930034,REC602,25,47,7.5,72
1783930034,REC064,18,42,7.5,60
1783930034,REC651,44,43,7.5,87
1783930034,REC652,46,44,7.5,90
1783930034,RIC653,34,40,7.5,74
1783930034,RIC651,30,39,7.5,69
1783930034,ROE072,24,34,7.46,58
1783930034,REC072,25,38,7.46,63
1783930034,REC075,25,53,7.46,78
1783930034,REC701,22,24,7.46,46
1783930034,REC702,25,47,7.46,72
1783930034,REC751,44,46,7.46,90
1783930034,REC752,40,46,7.46,86
1783930034,REC753,80,0,7.46,80
1783930034,REC754,160,0,7.46,160
1783930036,RAS101,21,44,7.83,65
1783930036,RAS102,25,49,7.83,74
1783930036,RAS103,28,53,7.83,81
1783930036,RME101,21,42,7.83,63
1783930036,RCS101,21,35,7.83,56
1783930036,RAS152,46,44,7.83,90
1783930036,RME151,41,44,7.83,85
1783930036,RCS151,41,40,7.83,81
1783930036,RCE151,46,40,7.83,86
1783930036,RAS203,26,49,7.25,75
1783930036,RAS201,15,34,7.25,49
1783930036,REE201,27,47,7.25,74
1783930036,RAS204,21,33,7.25,54
1783930036,REC201,28,25,7.25,53
1783930036,RAS251,44,46,7.25,90
1783930036,REE251,47,49,7.25,96
1783930036,RAS254,45,45,7.25,90
1783930036,RME252,44,40,7.25,84
1783930036,RAS301,28,57,7.5,85
1783930036,RVE301,17,32,7.5,49
1783930036,REE305,25,37,7.5,62
1783930036,REC301,24,37,7.5,61
1783930036,REC302,23,35,7.5,58
1783930036,REC303,28,55,7.5,83
1783930036,REC351,40,42,7.5,82
1783930036,REC352,38,35,7.5,73
1783930036,REC353,43,48,7.5,91
1783930036,REC354,39,43,7.5,82
1783930036,ROE047,26,39,6.67,65
1783930036,RAS402,16,28,6.67,44
1783930036,REC401,27,37,6.67,64
1783930036,REC402,24,49,6.67,73
1783930036,REC403,20,39,6.67,59
1783930036,RCS406,19,21,6.67,40
1783930036,REC451,45,40,6.67,85
1783930036,REC452,44,47,6.67,91
1783930036,REC453,43,46,6.67,89
1783930036,RCS456,44,40,6.67,84
1783930036,RAS501,25,35,7.17,60
1783930036,RAS502,23,37,7.17,60
1783930036,REC501A,19,45,7.17,64
1783930036,REC502,19,31,7.17,50
1783930036,REC503,23,38,7.17,61
1783930036,REC051,21,43,7.17,64
1783930036,REC551,42,47,7.17,89
1783930036,REC552,45,42,7.17,87
1783930036,REC553,42,42,7.17,84
1783930036,REC554,41,47,7.17,88
1783930036,RAS601,28,48,7.58,76
1783930036,RUC601,23,44,7.58,67
1783930036,RIC603,17,40,7.58,57
1783930036,REC601,27,47,7.58,74
1783930036,REC602,23,44,7.58,67
1783930036,REC064,19,41,7.58,60
1783930036,REC651,42,44,7.58,86
1783930036,REC652,45,45,7.58,90
1783930036,RIC653,40,43,7.58,83
1783930036,RIC651,45,45,7.58,90
1783930036,ROE072,25,25,7.25,50
1783930036,REC072,23,27,7.25,50
1783930036,REC075,24,50,7.25,74
1783930036,REC701,22,32,7.25,54
1783930036,REC702,24,34,7.25,58
1783930036,REC751,42,48,7.25,90
1783930036,REC752,38,48,7.25,86
1783930036,REC753,80,0,7.25,80
1783930036,REC754,170,0,7.25,170
1783930038,RAS101,17,36,7.08,53
1783930038,RAS102,20,23,7.08,43
1783930038,RAS103,23,48,7.08,71
1783930038,RME101,24,46,7.08,70
1783930038,RCS101,20,44,7.08,64
1783930038,RAS152,42,40,7.08,82
1783930038,RME151,44,44,7.08,88
1783930038,RCS151,40,42,7.08,82
1783930038,RCE151,43,39,7.08,82
1783930038,RAS203,19,30,6.5,49
1783930038,RAS201,15,33,6.5,48
1783930038,REE201,20,30,6.5,50
1783930038,RAS204,19,48,6.5,67
1783930038,REC201,18,36,6.5,54
1783930038,RAS251,40,45,6.5,85
1783930038,REE251,44,47,6.5,91
1783930038,RAS254,45,45,6.5,90
1783930038,RME252,42,38,6.5,80
1783930038,RAS301,15,26,5.88,41
1783930038,RVE301,18,30,5.88,48
1783930038,REE305,24,53,5.88,77
1783930038,REC301,22,24,5.88,46
1783930038,REC302,17,31,5.88,48
1783930038,REC303,16,48,5.88,64
1783930038,REC351,40,38,5.88,78
1783930038,REC352,34,35,5.88,69
1783930038,REC353,36,36,5.88,72
1783930038,REC354,30,35,5.88,65
1783930038,ROE047,18,44,6.63,62
1783930038,RAS402,18,44,6.63,62
1783930038,REC401,19,38,6.63,57
1783930038,REC402,16,31,6.63,47
1783930038,REC403,17,46,6.63,63
1783930038,RCS406,13,43,6.63,56
1783930038,REC451,37,38,6.63,75
1783930038,REC452,42,45,6.63,87
1783930038,REC453,35,38,6.63,73
1783930038,RCS456,30,42,6.63,72
1783930038,RAS501,22,40,7.33,62
1783930038,RAS502,23,47,7.33,70
1783930038,REC501A,15,35,7.33,50
1783930038,REC502,18,53,7.33,71
1783930038,REC503,13,56,7.33,69
1783930038,REC051,13,47,7.33,60
1783930038,REC551,36,36,7.33,72
1783930038,REC552,42,37,7.33,79
1783930038,REC553,38,38,7.33,76
1783930038,REC554,35,37,7.33,72
1783930038,RAS601,28,47,7.0,75
1783930038,RUC601,25,45,7.0,70
1783930038,RIC603,13,36,7.0,49
1783930038,REC601,25,45,7.0,70
1783930038,REC602,15,38,7.0,53
1783930038,REC064,16,38,7.0,54
1783930038,REC651,40,40,7.0,80
1783930038,REC652,35,39,7.0,74
1783930038,RIC653,30,37,7.0,67
1783930038,RIC651,30,37,7.0,67
1783930038,ROE072,22,39,6.96,61
1783930038,REC072,28,46,6.96,74
1783930038,REC075,26,33,6.96,59
1783930038,REC701,10,30,6.96,40
1783930038,REC702,26,46,6.96,72
1783930038,REC751,44,42,6.96,86
1783930038,REC752,39,42,6.96,81
1783930038,REC753,79,0,6.96,79
1783930038,REC754,150,0,6.96,150
1783930039,RAS101,18,30,6.75,48
1783930039,RAS102,24,32,6.75,56
1783930039,RAS103,25,34,6.75,59
1783930039,RME101,18,51,6.75,69
1783930039,RCS101,21,45,6.75,66
1783930039,RAS152,46,42,6.75,88
1783930039,RME151,40,47,6.75,87
1783930039,RCS151,41,39,6.75,80
1783930039,RCE151,44,39,6.75,83
1783930039,RAS203,15,31,6.46,46
1783930039,RAS201,15,27,6.46,42
1783930039,REE201,19,31,6.46,50
1783930039,RAS204,25,46,6.46,71
1783930039,REC201,22,30,6.46,52
1783930039,RAS251,42,46,6.46,88
1783930039,REE251,46,49,6.46,95
1783930039,RAS254,45,45,6.46,90
1783930039,RME252,42,39,6.46,81
1783930039,RAS301,13,10,4.63,23
1783930039,RVE301,19,34,4.63,53
1783930039,REE305,23,23,4.63,46
1783930039,REC301,18,36,4.63,54
1783930039,REC302,18,26,4.63,44
1783930039,REC303,15,29,4.63,44
1783930039,REC351,38,38,4.63,76
1783930039,REC352,42,36,4.63,78
1783930039,REC353,42,35,4.63,77
1783930039,REC354,42,37,4.63,79
1783930039,ROE047,21,43,6.25,64
1783930039,RAS402,20,48,6.25,68
1783930039,REC401,15,39,6.25,54
1783930039,REC402,12,28,6.25,40
1783930039,REC403,15,36,6.25,51
1783930039,RCS406,13,33,6.25,46
1783930039,REC451,39,35,6.25,74
1783930039,REC452,38,41,6.25,79
1783930039,REC453,41,44,6.25,85
1783930039,RCS456,41,43,6.25,84
1783930039,RAS501,25,41,6.33,66
1783930039,RAS502,23,43,6.33,66
1783930039,REC501A,15,43,6.33,58
1783930039,REC502,17,35,6.33,52
1783930039,REC503,12,29,6.33,41
1783930039,REC051,12,43,6.33,55
1783930039,REC551,31,40,6.33,71
1783930039,REC552,44,38,6.33,82
1783930039,REC553,35,37,6.33,72
1783930039,REC554,30,36,6.33,66
1783930039,RAS601,27,44,6.96,71
1783930039,RUC601,23,41,6.96,64
1783930039,RIC603,15,36,6.96,51
1783930039,REC601,19,38,6.96,57
1783930039,REC602,22,40,6.96,62
1783930039,REC064,15,36,6.96,51
1783930039,REC651,44,42,6.96,86
1783930039,REC652,44,42,6.96,86
1783930039,RIC653,39,41,6.96,80
1783930039,RIC651,33,39,6.96,72
1783930039,ROE072,22,28,7.13,50
1783930039,REC072,28,32,7.13,60
1783930039,REC075,24,43,7.13,67
1783930039,REC701,18,30,7.13,48
1783930039,REC702,24,46,7.13,70
1783930039,REC751,44,42,7.13,86
1783930039,REC752,37,42,7.13,79
1783930039,REC753,75,0,7.13,75
1783930039,REC754,165,0,7.13,165
1783930040,RAS101,16,45,7.29,61
1783930040,RAS102,20,41,7.29,61
1783930040,RAS103,23,40,7.29,63
1783930040,RME101,18,46,7.29,64
1783930040,RCS101,24,33,7.29,57
1783930040,RAS152,42,40,7.29,82
1783930040,RME151,40,45,7.29,85
1783930040,RCS151,44,45,7.29,89
1783930040,RCE151,45,38,7.29,83
1783930040,RAS203,26,36,7.5,62
1783930040,RAS201,21,46,7.5,67
1783930040,REE201,22,39,7.5,61
1783930040,RAS204,23,44,7.5,67
1783930040,REC201,20,43,7.5,63
1783930040,RAS251,42,45,7.5,87
1783930040,REE251,45,48,7.5,93
1783930040,RAS254,45,47,7.5,92
1783930040,RME252,42,38,7.5,80
1783930040,RAS301,19,26,6.21,45
1783930040,RVE301,18,43,6.21,61
1783930040,REE305,21,31,6.21,52
1783930040,REC301,19,23,6.21,42
1783930040,REC302,18,32,6.21,50
1783930040,REC303,18,48,6.21,66
1783930040,REC351,43,44,6.21,87
1783930040,REC352,38,33,6.21,71
1783930040,REC353,36,40,6.21,76
1783930040,REC354,35,37,6.21,72
1783930040,ROE047,25,45,7.08,70
1783930040,RAS402,20,35,7.08,55
1783930040,REC401,16,53,7.08,69
1783930040,REC402,20,36,7.08,56
1783930040,REC403,22,42,7.08,64
1783930040,RCS406,19,38,7.08,57
1783930040,REC451,40,35,7.08,75
1783930040,REC452,40,43,7.08,83
1783930040,REC453,46,49,7.08,95
1783930040,RCS456,41,43,7.08,84
1783930040,RAS501,29,40,7.21,69
1783930040,RAS502,23,45,7.21,68
1783930040,REC501A,18,45,7.21,63
1783930040,REC502,18,44,7.21,62
1783930040,REC503,14,49,7.21,63
1783930040,REC051,20,46,7.21,66
1783930040,REC551,34,42,7.21,76
1783930040,REC552,44,37,7.21,81
1783930040,REC553,35,38,7.21,73
1783930040,REC554,33,43,7.21,76
1783930040,RAS601,28,49,7.29,77
1783930040,RUC601,23,45,7.29,68
1783930040,RIC603,16,40,7.29,56
1783930040,REC601,19,42,7.29,61
1783930040,REC602,26,47,7.29,73
1783930040,REC064,15,40,7.29,55
1783930040,REC651,43,42,7.29,85
1783930040,REC652,45,43,7.29,88
1783930040,RIC653,39,41,7.29,80
1783930040,RIC651,40,41,7.29,81
1783930040,ROE072,22,43,7.75,65
1783930040,REC072,29,41,7.75,70
1783930040,REC075,26,40,7.75,66
1783930040,REC701,26,42,7.75,68
1783930040,REC702,26,43,7.75,69
1783930040,REC751,47,44,7.75,91
1783930040,REC752,39,44,7.75,83
1783930040,REC753,81,0,7.75,81
1783930040,REC754,170,0,7.75,170
1783930041,RAS101,20,51,8.17,71
1783930041,RAS102,28,56,8.17,84
1783930041,RAS103,21,39,8.17,60
1783930041,RME101,27,48,8.17,75
1783930041,RCS101,24,36,8.17,60
1783930041,RAS152,48,47,8.17,95
1783930041,RME151,46,44,8.17,90
1783930041,RCS151,44,44,8.17,88
1783930041,RCE151,44,39,8.17,83
1783930041,RAS203,20,63,8.42,83
1783930041,RAS201,15,56,8.42,71
1783930041,REE201,26,59,8.42,85
1783930041,RAS204,24,39,8.42,63
1783930041,REC201,19,51,8.42,70
1783930041,RAS251,40,46,8.42,86
1783930041,REE251,45,48,8.42,93
1783930041,RAS254,45,45,8.42,90
1783930041,RME252,43,36,8.42,79
1783930041,RAS301,23,37,7.75,60
1783930041,RVE301,21,51,7.75,72
1783930041,REE305,27,41,7.75,68
1783930041,REC301,25,43,7.75,68
1783930041,REC302,22,57,7.75,79
1783930041,REC303,23,55,7.75,78
1783930041,REC351,44,36,7.75,80
1783930041,REC352,36,44,7.75,80
1783930041,REC353,39,45,7.75,84
1783930041,REC354,39,44,7.75,83
1783930041,ROE047,28,49,7.79,77
1783930041,RAS402,17,52,7.79,69
1783930041,REC401,25,42,7.79,67
1783930041,REC402,24,60,7.79,84
1783930041,REC403,23,39,7.79,62
1783930041,RCS406,21,48,7.79,69
1783930041,REC451,40,40,7.79,80
1783930041,REC452,43,45,7.79,88
1783930041,REC453,42,46,7.79,88
1783930041,RCS456,41,38,7.79,79
1783930041,RAS501,28,48,8.21,76
1783930041,RAS502,24,52,8.21,76
1783930041,REC501A,19,55,8.21,74
1783930041,REC502,26,50,8.21,76
1783930041,REC503,26,49,8.21,75
1783930041,REC051,24,50,8.21,74
1783930041,REC551,38,44,8.21,82
1783930041,REC552,48,43,8.21,91
1783930041,REC553,44,42,8.21,86
1783930041,REC554,37,44,8.21,81
1783930041,RAS601,28,55,8.21,83
1783930041,RUC601,26,53,8.21,79
1783930041,RIC603,19,48,8.21,67
1783930041,REC601,27,54,8.21,81
1783930041,REC602,27,54,8.21,81
1783930041,REC064,20,49,8.21,69
1783930041,REC651,45,44,8.21,89
1783930041,REC652,45,44,8.21,89
1783930041,RIC653,40,42,8.21,82
1783930041,RIC651,30,39,8.21,69
1783930041,ROE072,23,37,7.88,60
1783930041,REC072,23,46,7.88,69
1783930041,REC075,24,38,7.88,62
1783930041,REC701,23,40,7.88,63
1783930041,REC702,24,50,7.88,74
1783930041,REC751,42,50,7.88,92
1783930041,REC752,39,50,7.88,89
1783930041,REC753,88,0,7.88,88
1783930041,REC754,180,0,7.88,180
1783930042,RAS101,17,40,6.13,57
1783930042,RAS102,19,28,6.13,47
1783930042,RAS103,20,29,6.13,49
1783930042,RME101,20,27,6.13,47
1783930042,RCS101,24,35,6.13,59
1783930042,RAS152,41,39,6.13,80
1783930042,RME151,42,46,6.13,88
1783930042,RCS151,44,44,6.13,88
1783930042,RCE151,42,39,6.13,81
1783930042,RAS203,18,31,6.67,49
1783930042,RAS201,17,42,6.67,59
1783930042,REE201,25,46,6.67,71
1783930042,RAS204,19,41,6.67,60
1783930042,REC201,17,26,6.67,43
1783930042,RAS251,48,45,6.67,93
1783930042,REE251,47,47,6.67,94
1783930042,RAS254,42,47,6.67,89
1783930042,RME252,45,35,6.67,80
1783930042,RAS301,18,35,6.63,53
1783930042,RVE301,14,32,6.63,46
1783930042,REE305,24,48,6.63,72
1783930042,REC301,22,37,6.63,59
1783930042,REC302,16,42,6.63,58
1783930042,REC303,20,46,6.63,66
1783930042,REC351,42,37,6.63,79
1783930042,REC352,34,39,6.63,73
1783930042,REC353,43,41,6.63,84
1783930042,REC354,38,37,6.63,75
1783930042,ROE047,21,41,4.42,62
1783930042,RAS402,14,22,4.42,36
1783930042,REC401,17,24,4.42,41
1783930042,REC402,17,32,4.42,49
1783930042,REC403,17,26,4.42,43
1783930042,RCS406,18,21,4.42,39
1783930042,REC451,38,38,4.42,76
1783930042,REC452,42,45,4.42,87
1783930042,REC453,42,46,4.42,88
1783930042,RCS456,41,37,4.42,78
1783930042,RAS501,23,40,7.13,63
1783930042,RAS502,23,46,7.13,69
1783930042,REC501A,24,44,7.13,68
1783930042,REC502,22,40,7.13,62
1783930042,REC503,19,42,7.13,61
1783930042,REC051,20,33,7.13,53
1783930042,REC551,44,43,7.13,87
1783930042,REC552,46,39,7.13,85
1783930042,REC553,39,38,7.13,77
1783930042,REC554,43,44,7.13,87
1783930042,RAS601,28,45,7.25,73
1783930042,RUC601,25,43,7.25,68
1783930042,RIC603,17,37,7.25,54
1783930042,REC601,27,44,7.25,71
1783930042,REC602,15,36,7.25,51
1783930042,REC064,16,36,7.25,52
1783930042,REC651,46,43,7.25,89
1783930042,REC652,42,42,7.25,84
1783930042,RIC653,39,41,7.25,80
1783930042,RIC651,47,43,7.25,90
1783930042,ROE072,23,32,7.38,55
1783930042,REC072,29,31,7.38,60
1783930042,REC075,25,37,7.38,62
1783930042,REC701,25,30,7.38,55
1783930042,REC702,22,48,7.38,70
1783930042,REC751,48,48,7.38,96
1783930042,REC752,39,48,7.38,87
1783930042,REC753,78,0,7.38,78
1783930042,REC754,165,0,7.38,165
1783930043,RAS101,27,44,8.17,71
1783930043,RAS102,28,62,8.17,90
1783930043,RAS103,23,40,8.17,63
1783930043,RME101,25,52,8.17,77
1783930043,RCS101,23,36,8.17,59
1783930043,RAS152,48,46,8.17,94
1783930043,RME151,45,44,8.17,89
1783930043,RCS151,43,40,8.17,83
1783930043,RCE151,44,40,8.17,84
1783930043,RAS203,26,66,8.25,92
1783930043,RAS201,23,34,8.25,57
1783930043,REE201,29,61,8.25,90
1783930043,RAS204,24,40,8.25,64
1783930043,REC201,23,42,8.25,65
1783930043,RAS251,46,46,8.25,92
1783930043,REE251,49,47,8.25,96
1783930043,RAS254,45,40,8.25,85
1783930043,RME252,40,35,8.25,75
1783930043,RAS301,25,34,7.96,59
1783930043,RVE301,21,43,7.96,64
1783930043,REE305,28,52,7.96,80
1783930043,REC301,26,51,7.96,77
1783930043,REC302,23,54,7.96,77
1783930043,REC303,28,57,7.96,85
1783930043,REC351,44,42,7.96,86
1783930043,REC352,42,38,7.96,80
1783930043,REC353,39,49,7.96,88
1783930043,REC354,35,45,7.96,80
1783930043,ROE047,24,45,7.29,69
1783930043,RAS402,20,38,7.29,58
1783930043,REC401,22,48,7.29,70
1783930043,REC402,19,55,7.29,74
1783930043,REC403,18,36,7.29,54
1783930043,RCS406,18,51,7.29,69
1783930043,REC451,40,37,7.29,77
1783930043,REC452,45,47,7.29,92
1783930043,REC453,42,46,7.29,88
1783930043,RCS456,30,37,7.29,67
1783930043,RAS501,29,50,7.58,79
1783930043,RAS502,23,55,7.58,78
1783930043,REC501A,22,53,7.58,75
1783930043,REC502,20,40,7.58,60
1783930043,REC503,17,53,7.58,70
1783930043,REC051,19,37,7.58,56
1783930043,REC551,45,36,7.58,81
1783930043,REC552,46,38,7.58,84
1783930043,REC553,33,38,7.58,71
1783930043,REC554,44,35,7.58,79
1783930043,RAS601,29,54,8.21,83
1783930043,RUC601,26,52,8.21,78
1783930043,RIC603,25,52,8.21,77
1783930043,REC601,29,54,8.21,83
1783930043,REC602,24,51,8.21,75
1783930043,REC064,18,47,8.21,65
1783930043,REC651,43,42,8.21,85
1783930043,REC652,40,41,8.21,81
1783930043,RIC653,46,43,8.21,89
1783930043,RIC651,30,38,8.21,68
1783930043,ROE072,23,36,7.42,59
1783930043,REC072,28,46,7.42,74
1783930043,REC075,25,44,7.42,69
1783930043,REC701,19,37,7.42,56
1783930043,REC702,25,48,7.42,73
1783930043,REC751,47,46,7.42,93
1783930043,REC752,45,46,7.42,91
1783930043,REC753,77,0,7.42,77
1783930043,REC754,150,0,7.42,150
1783930044,RAS101,15,25,6.25,40
1783930044,RAS102,19,29,6.25,48
1783930044,RAS103,22,39,6.25,61
1783930044,RME101,18,40,6.25,58
1783930044,RCS101,20,39,6.25,59
1783930044,RAS152,39,37,6.25,76
1783930044,RME151,40,45,6.25,85
1783930044,RCS151,40,40,6.25,80
1783930044,RCE151,46,40,6.25,86
1783930044,RAS203,15,39,6.46,54
1783930044,RAS201,15,46,6.46,61
1783930044,REE201,19,24,6.46,43
1783930044,RAS204,17,35,6.46,52
1783930044,REC201,16,36,6.46,52
1783930044,RAS251,45,46,6.46,91
1783930044,REE251,42,47,6.46,89
1783930044,RAS254,42,48,6.46,90
1783930044,RME252,40,38,6.46,78
1783930044,RAS301,14,21,3.79,35
1783930044,RVE301,14,27,3.79,41
1783930044,REE305,18,42,3.79,60
1783930044,REC301,16,16,3.79,32
1783930044,REC302,14,26,3.79,40
1783930044,REC303,13,29,3.79,42
1783930044,REC351,39,37,3.79,76
1783930044,REC352,30,37,3.79,67
1783930044,REC353,36,35,3.79,71
1783930044,REC354,28,38,3.79,66
1783930044,ROE047,14,39,5.08,53
1783930044,RAS402,13,33,5.08,46
1783930044,REC401,15,34,5.08,49
1783930044,REC402,12,32,5.08,44
1783930044,REC403,13,38,5.08,51
1783930044,RCS406,11,21,5.08,32
1783930044,REC451,35,35,5.08,70
1783930044,REC452,32,48,5.08,80
1783930044,REC453,35,39,5.08,74
1783930044,RCS456,44,38,5.08,82
1783930044,RAS501,23,37,4.75,60
1783930044,RAS502,22,34,4.75,56
1783930044,REC501A,13,24,4.75,37
1783930044,REC502,17,36,4.75,53
1783930044,REC503,12,41,4.75,53
1783930044,REC051,11,20,4.75,31
1783930044,REC551,36,38,4.75,74
1783930044,REC552,46,40,4.75,86
1783930044,REC553,35,39,4.75,74
1783930044,REC554,35,42,4.75,77
1783930044,RAS601,28,42,6.17,70
1783930044,RUC601,25,40,6.17,65
1783930044,RIC603,13,31,6.17,44
1783930044,REC601,17,34,6.17,51
1783930044,REC602,15,33,6.17,48
1783930044,REC064,15,33,6.17,48
1783930044,REC651,40,41,6.17,81
1783930044,REC652,38,40,6.17,78
1783930044,RIC653,34,39,6.17,73
1783930044,RIC651,30,38,6.17,68
1783930044,ROE072,24,34,5.17,58
1783930044,REC072,17,23,5.17,40
1783930044,REC075,20,40,5.17,60
1783930044,REC701,14,23,5.17,37
1783930044,REC702,20,38,5.17,58
1783930044,REC751,36,0,5.17,36
1783930044,REC752,36,42,5.17,78
1783930044,REC753,75,0,5.17,75
1783930044,REC754,145,0,5.17,145
1783930045,RAS101,15,50,6.25,65
1783930045,RAS102,19,37,6.25,56
1783930045,RAS103,21,23,6.25,44
1783930045,RME101,18,27,6.25,45
1783930045,RCS101,20,35,6.25,55
1783930045,RAS152,39,36,6.25,75
1783930045,RME151,40,47,6.25,87
1783930045,RCS151,40,41,6.25,81
1783930045,RCE151,44,39,6.25,83
1783930045,RAS203,15,49,6.46,64
1783930045,RAS201,15,42,6.46,57
1783930045,REE201,19,29,6.46,48
1783930045,RAS204,19,42,6.46,61
1783930045,REC201,14,32,6.46,46
1783930045,RAS251,45,45,6.46,90
1783930045,REE251,40,46,6.46,86
1783930045,RAS254,42,40,6.46,82
1783930045,RME252,30,35,6.46,65
1783930045,RAS301,14,2,4.25,16
1783930045,RVE301,25,31,4.25,56
1783930045,REE305,20,29,4.25,49
1783930045,REC301,21,10,4.25,31
1783930045,REC302,14,41,4.25,55
1783930045,REC303,13,36,4.25,49
1783930045,REC351,41,36,4.25,77
1783930045,REC352,32,33,4.25,65
1783930045,REC353,35,35,4.25,70
1783930045,REC354,28,33,4.25,61
1783930045,ROE047,12,37,3.63,49
1783930045,RAS402,24,30,3.63,54
1783930045,REC401,15,43,3.63,58
1783930045,REC402,11,18,3.63,29
1783930045,REC403,15,11,3.63,26
1783930045,RCS406,9,7,3.63,16
1783930045,REC451,37,35,3.63,72
1783930045,REC452,32,36,3.63,68
1783930045,REC453,35,39,3.63,74
1783930045,RCS456,40,39,3.63,79
1783930045,RAS501,22,46,3.75,68
1783930045,RAS502,21,17,3.75,38
1783930045,REC501A,10,32,3.75,42
1783930045,REC502,18,37,3.75,55
1783930045,REC503,11,14,3.75,25
1783930045,REC051,10,7,3.75,17
1783930045,REC551,34,36,3.75,70
1783930045,REC552,45,39,3.75,84
1783930045,REC553,33,38,3.75,71
1783930045,REC554,33,42,3.75,75
1783930045,RAS601,27,39,6.13,66
1783930045,RUC601,19,33,6.13,52
1783930045,RIC603,13,29,6.13,42
1783930045,REC601,21,35,6.13,56
1783930045,REC602,20,34,6.13,54
1783930045,REC064,15,31,6.13,46
1783930045,REC651,46,41,6.13,87
1783930045,REC652,41,39,6.13,80
1783930045,RIC653,33,37,6.13,70
1783930045,RIC651,35,38,6.13,73
1783930045,ROE072,23,44,6.83,67
1783930045,REC072,27,28,6.83,55
1783930045,REC075,26,36,6.83,62
1783930045,REC701,19,27,6.83,46
1783930045,REC702,23,34,6.83,57
1783930045,REC751,45,46,6.83,91
1783930045,REC752,41,46,6.83,87
1783930045,REC753,78,0,6.83,78
1783930045,REC754,150,0,6.83,150
1783930047,RAS101,20,44,7.63,64
1783930047,RAS102,27,45,7.63,72
1783930047,RAS103,20,50,7.63,70
1783930047,RME101,23,27,7.63,50
1783930047,RCS101,22,43,7.63,65
1783930047,RAS152,46,44,7.63,90
1783930047,RME151,43,46,7.63,89
1783930047,RCS151,42,39,7.63,81
1783930047,RCE151,44,39,7.63,83
1783930047,RAS203,27,42,7.17,69
1783930047,RAS201,17,33,7.17,50
1783930047,REE201,26,30,7.17,56
1783930047,RAS204,21,46,7.17,67
1783930047,REC201,19,49,7.17,68
1783930047,RAS251,46,46,7.17,92
1783930047,REE251,47,47,7.17,94
1783930047,RAS254,40,45,7.17,85
1783930047,RME252,46,36,7.17,82
1783930047,RAS301,21,42,6.71,63
1783930047,RVE301,19,40,6.71,59
1783930047,REE305,24,35,6.71,59
1783930047,REC301,27,27,6.71,54
1783930047,REC302,20,36,6.71,56
1783930047,REC303,24,45,6.71,69
1783930047,REC351,44,44,6.71,88
1783930047,REC352,38,37,6.71,75
1783930047,REC353,43,44,6.71,87
1783930047,REC354,32,40,6.71,72
1783930047,ROE047,21,37,6.92,58
1783930047,RAS402,21,37,6.92,58
1783930047,REC401,15,34,6.92,49
1783930047,REC402,22,44,6.92,66
1783930047,REC403,27,37,6.92,64
1783930047,RCS406,19,51,6.92,70
1783930047,REC451,39,40,6.92,79
1783930047,REC452,48,49,6.92,97
1783930047,REC453,46,48,6.92,94
1783930047,RCS456,41,37,6.92,78
1783930047,RAS501,24,46,7.38,70
1783930047,RAS502,23,45,7.38,68
1783930047,REC501A,22,39,7.38,61
1783930047,REC502,23,34,7.38,57
1783930047,REC503,22,38,7.38,60
1783930047,REC051,24,41,7.38,65
1783930047,REC551,46,45,7.38,91
1783930047,REC552,46,42,7.38,88
1783930047,REC553,42,41,7.38,83
1783930047,REC554,45,45,7.38,90
1783930047,RAS601,28,48,8.08,76
1783930047,RUC601,26,46,8.08,72
1783930047,RIC603,26,46,8.08,72
1783930047,REC601,25,46,8.08,71
1783930047,REC602,25,46,8.08,71
1783930047,REC064,20,42,8.08,62
1783930047,REC651,46,44,8.08,90
1783930047,REC652,40,42,8.08,82
1783930047,RIC653,46,44,8.08,90
1783930047,RIC651,42,43,8.08,85
1783930047,ROE072,25,47,7.79,72
1783930047,REC072,23,38,7.79,61
1783930047,REC075,24,35,7.79,59
1783930047,REC701,26,44,7.79,70
1783930047,REC702,24,48,7.79,72
1783930047,REC751,44,46,7.79,90
1783930047,REC752,36,46,7.79,82
1783930047,REC753,75,0,7.79,75
1783930047,REC754,170,0,7.79,170
1783930048,RAS101,18,46,7.54,64
1783930048,RAS102,27,33,7.54,60
1783930048,RAS103,22,61,7.54,83
1783930048,RME101,27,23,7.54,50
1783930048,RCS101,26,30,7.54,56
1783930048,RAS152,47,46,7.54,93
1783930048,RME151,46,44,7.54,90
1783930048,RCS151,46,43,7.54,89
1783930048,RCE151,42,39,7.54,81
1783930048,RAS203,24,33,7.54,57
1783930048,RAS201,25,48,7.54,73
1783930048,REE201,26,50,7.54,76
1783930048,RAS204,26,23,7.54,49
1783930048,REC201,21,43,7.54,64
1783930048,RAS251,48,45,7.54,93
1783930048,REE251,42,48,7.54,90
1783930048,RAS254,45,47,7.54,92
1783930048,RME252,48,42,7.54,90
1783930048,RAS301,24,40,6.92,64
1783930048,RVE301,19,31,6.92,50
1783930048,REE305,25,40,6.92,65
1783930048,REC301,27,35,6.92,62
1783930048,REC302,20,35,6.92,55
1783930048,REC303,25,32,6.92,57
1783930048,REC351,47,46,6.92,93
1783930048,REC352,34,40,6.92,74
1783930048,REC353,40,46,6.92,86
1783930048,REC354,39,43,6.92,82
1783930048,ROE047,24,41,7.46,65
1783930048,RAS402,20,42,7.46,62
1783930048,REC401,20,31,7.46,51
1783930048,REC402,28,48,7.46,76
1783930048,REC403,23,32,7.46,55
1783930048,RCS406,20,52,7.46,72
1783930048,REC451,43,42,7.46,85
1783930048,REC452,48,49,7.46,97
1783930048,REC453,46,48,7.46,94
1783930048,RCS456,44,38,7.46,82
1783930048,RAS501,28,38,7.63,66
1783930048,RAS502,23,47,7.63,70
1783930048,REC501A,26,47,7.63,73
1783930048,REC502,23,50,7.63,73
1783930048,REC503,22,28,7.63,50
1783930048,REC051,25,37,7.63,62
1783930048,REC551,45,42,7.63,87
1783930048,REC552,47,42,7.63,89
1783930048,REC553,42,41,7.63,83
1783930048,REC554,44,45,7.63,89
1783930048,RAS601,28,48,7.67,76
1783930048,RUC601,24,45,7.67,69
1783930048,RIC603,22,43,7.67,65
1783930048,REC601,27,47,7.67,74
1783930048,REC602,22,43,7.67,65
1783930048,REC064,20,42,7.67,62
1783930048,REC651,46,45,7.67,91
1783930048,REC652,45,45,7.67,90
1783930048,RIC653,42,44,7.67,86
1783930048,RIC651,35,42,7.67,77
1783930048,ROE072,25,27,7.67,52
1783930048,REC072,23,38,7.67,61
1783930048,REC075,25,44,7.67,69
1783930048,REC701,28,42,7.67,70
1783930048,REC702,25,29,7.67,54
1783930048,REC751,44,48,7.67,92
1783930048,REC752,40,48,7.67,88
1783930048,REC753,88,0,7.67,88
1783930048,REC754,180,0,7.67,180
1783930049,RAS101,13,31,4.67,44
1783930049,RAS102,20,21,4.67,41
1783930049,RAS103,21,1,4.67,22
1783930049,RME101,16,27,4.67,43
1783930049,RCS101,22,35,4.67,57
1783930049,RAS152,47,45,4.67,92
1783930049,RME151,40,45,4.67,85
1783930049,RCS151,42,40,4.67,82
1783930049,RCE151,43,39,4.67,82
1783930049,RAS203,15,27,6.25,42
1783930049,RAS201,15,35,6.25,50
1783930049,REE201,19,41,6.25,60
1783930049,RAS204,19,38,6.25,57
1783930049,REC201,14,35,6.25,49
1783930049,RAS251,45,46,6.25,91
1783930049,REE251,42,47,6.25,89
1783930049,RAS254,45,40,6.25,85
1783930049,RME252,39,39,6.25,78
1783930049,RAS301,18,22,5.17,40
1783930049,RVE301,18,43,5.17,61
1783930049,REE305,21,42,5.17,63
1783930049,REC301,17,10,5.17,27
1783930049,REC302,15,44,5.17,59
1783930049,REC303,14,26,5.17,40
1783930049,REC351,42,37,5.17,79
1783930049,REC352,32,36,5.17,68
1783930049,REC353,36,36,5.17,72
1783930049,REC354,35,33,5.17,68
1783930049,ROE047,18,32,6.38,50
1783930049,RAS402,16,32,6.38,48
1783930049,REC401,18,29,6.38,47
1783930049,REC402,17,35,6.38,52
1783930049,REC403,23,37,6.38,60
1783930049,RCS406,16,41,6.38,57
1783930049,REC451,42,40,6.38,82
1783930049,REC452,40,43,6.38,83
1783930049,REC453,42,46,6.38,88
1783930049,RCS456,44,42,6.38,86
1783930049,RAS501,25,36,6.25,61
1783930049,RAS502,23,52,6.25,75
1783930049,REC501A,19,43,6.25,62
1783930049,REC502,15,26,6.25,41
1783930049,REC503,10,31,6.25,41
1783930049,REC051,19,36,6.25,55
1783930049,REC551,33,40,6.25,73
1783930049,REC552,45,41,6.25,86
1783930049,REC553,37,40,6.25,77
1783930049,REC554,32,36,6.25,68
1783930049,RAS601,26,41,6.58,67
1783930049,RUC601,22,38,6.58,60
1783930049,RIC603,15,34,6.58,49
1783930049,REC601,27,42,6.58,69
1783930049,REC602,21,38,6.58,59
1783930049,REC064,15,34,6.58,49
1783930049,REC651,42,42,6.58,84
1783930049,REC652,38,40,6.58,78
1783930049,RIC653,39,41,6.58,80
1783930049,RIC651,42,42,6.58,84
1783930049,ROE072,23,39,7.46,62
1783930049,REC072,28,38,7.46,66
1783930049,REC075,29,39,7.46,68
1783930049,REC701,21,52,7.46,73
1783930049,REC702,23,26,7.46,49
1783930049,REC751,48,48,7.46,96
1783930049,REC752,46,48,7.46,94
1783930049,REC753,85,0,7.46,85
1783930049,REC754,150,0,7.46,150
1783930050,RAS101,15,48,8.08,63
1783930050,RAS102,22,57,8.08,79
1783930050,RAS103,22,57,8.08,79
1783930050,RME101,28,45,8.08,73
1783930050,RCS101,28,45,8.08,73
1783930050,RAS152,41,42,8.08,83
1783930050,RME151,40,47,8.08,87
1783930050,RCS151,48,45,8.08,93
1783930050,RCE151,44,39,8.08,83
1783930050,RAS203,18,42,7.96,60
1783930050,RAS201,17,53,7.96,70
1783930050,REE201,25,45,7.96,70
1783930050,RAS204,26,39,7.96,65
1783930050,REC201,23,44,7.96,67
1783930050,RAS251,44,46,7.96,90
1783930050,REE251,45,47,7.96,92
1783930050,RAS254,45,47,7.96,92
1783930050,RME252,49,42,7.96,91
1783930050,RAS301,21,63,8.17,84
1783930050,RVE301,23,37,8.17,60
1783930050,REE305,28,46,8.17,74
1783930050,REC301,27,49,8.17,76
1783930050,REC302,19,51,8.17,70
1783930050,REC303,26,49,8.17,75
1783930050,REC351,45,44,8.17,89
1783930050,REC352,44,36,8.17,80
1783930050,REC353,36,46,8.17,82
1783930050,REC354,33,39,8.17,72
1783930050,ROE047,28,47,8.42,75
1783930050,RAS402,20,56,8.42,76
1783930050,REC401,27,48,8.42,75
1783930050,REC402,23,51,8.42,74
1783930050,REC403,30,51,8.42,81
1783930050,RCS406,22,56,8.42,78
1783930050,REC451,42,45,8.42,87
1783930050,REC452,46,48,8.42,94
1783930050,REC453,44,48,8.42,92
1783930050,RCS456,44,49,8.42,93
1783930050,RAS501,30,56,8.17,86
1783930050,RAS502,26,51,8.17,77
1783930050,REC501A,21,54,8.17,75
1783930050,REC502,24,51,8.17,75
1783930050,REC503,19,56,8.17,75
1783930050,REC051,23,39,8.17,62
1783930050,REC551,41,42,8.17,83
1783930050,REC552,46,45,8.17,91
1783930050,REC553,38,45,8.17,83
1783930050,REC554,40,42,8.17,82
1783930050,RAS601,28,55,8.25,83
1783930050,RUC601,24,52,8.25,76
1783930050,RIC603,22,50,8.25,72
1783930050,REC601,25,53,8.25,78
1783930050,REC602,28,55,8.25,83
1783930050,REC064,19,48,8.25,67
1783930050,REC651,43,45,8.25,88
1783930050,REC652,48,46,8.25,94
1783930050,RIC653,41,44,8.25,85
1783930050,RIC651,33,42,8.25,75
1783930050,ROE072,26,46,8.5,72
1783930050,REC072,28,46,8.5,74
1783930050,REC075,29,57,8.5,86
1783930050,REC701,25,39,8.5,64
1783930050,REC702,29,53,8.5,82
1783930050,REC751,48,46,8.5,94
1783930050,REC752,46,46,8.5,92
1783930050,REC753,80,0,8.5,80
1783930050,REC754,165,0,8.5,165
1783930051,RAS101,24,44,7.54,68
1783930051,RAS102,29,44,7.54,73
1783930051,RAS103,22,34,7.54,56
1783930051,RME101,23,47,7.54,70
1783930051,RCS101,23,36,7.54,59
1783930051,RAS152,46,44,7.54,90
1783930051,RME151,47,47,7.54,94
1783930051,RCS151,43,39,7.54,82
1783930051,RCE151,46,38,7.54,84
1783930051,RAS203,24,49,8.38,73
1783930051,RAS201,21,55,8.38,76
1783930051,REE201,25,45,8.38,70
1783930051,RAS204,26,39,8.38,65
1783930051,REC201,20,61,8.38,81
1783930051,RAS251,44,48,8.38,92
1783930051,REE251,45,49,8.38,94
1783930051,RAS254,45,47,8.38,92
1783930051,RME252,49,40,8.38,89
1783930051,RAS301,25,46,8.29,71
1783930051,RVE301,27,58,8.29,85
1783930051,REE305,26,68,8.29,94
1783930051,REC301,24,42,8.29,66
1783930051,REC302,18,54,8.29,72
1783930051,REC303,23,49,8.29,72
1783930051,REC351,41,40,8.29,81
1783930051,REC352,36,39,8.29,75
1783930051,REC353,36,42,8.29,78
1783930051,REC354,39,37,8.29,76
1783930051,ROE047,27,60,8.67,87
1783930051,RAS402,20,50,8.67,70
1783930051,REC401,27,51,8.67,78
1783930051,REC402,27,48,8.67,75
1783930051,REC403,27,64,8.67,91
1783930051,RCS406,20,56,8.67,76
1783930051,REC451,44,45,8.67,89
1783930051,REC452,48,49,8.67,97
1783930051,REC453,46,49,8.67,95
1783930051,RCS456,44,42,8.67,86
1783930051,RAS501,30,60,9.04,90
1783930051,RAS502,30,55,9.04,85
1783930051,REC501A,24,48,9.04,72
1783930051,REC502,30,60,9.04,90
1783930051,REC503,21,60,9.04,81
1783930051,REC051,29,44,9.04,73
1783930051,REC551,41,47,9.04,88
1783930051,REC552,48,47,9.04,95
1783930051,REC553,41,46,9.04,87
1783930051,REC554,40,40,9.04,80
1783930051,RAS601,28,56,8.5,84
1783930051,RUC601,22,51,8.5,73
1783930051,RIC603,24,53,8.5,77
1783930051,REC601,25,54,8.5,79
1783930051,REC602,30,57,8.5,87
1783930051,REC064,21,51,8.5,72
1783930051,REC651,45,45,8.5,90
1783930051,REC652,49,46,8.5,95
1783930051,RIC653,47,45,8.5,92
1783930051,RIC651,33,41,8.5,74
1783930051,ROE072,27,46,8.5,73
1783930051,REC072,21,56,8.5,77
1783930051,REC075,29,51,8.5,80
1783930051,REC701,25,44,8.5,69
1783930051,REC702,29,53,8.5,82
1783930051,REC751,48,50,8.5,98
1783930051,REC752,42,50,8.5,92
1783930051,REC753,89,0,8.5,89
1783930051,REC754,175,0,8.5,175
1783930053,RAS101,27,46,8.71,73
1783930053,RAS102,28,56,8.71,84
1783930053,RAS103,22,70,8.71,92
1783930053,RME101,26,53,8.71,79
1783930053,RCS101,28,39,8.71,67
1783930053,RAS152,48,46,8.71,94
1783930053,RME151,45,48,8.71,93
1783930053,RCS151,48,47,8.71,95
1783930053,RCE151,45,40,8.71,85
1783930053,RAS203,29,63,9.38,92
1783930053,RAS201,23,61,9.38,84
1783930053,REE201,30,53,9.38,83
1783930053,RAS204,29,51,9.38,80
1783930053,REC201,28,58,9.38,86
1783930053,RAS251,46,46,9.38,92
1783930053,REE251,49,48,9.38,97
1783930053,RAS254,49,48,9.38,97
1783930053,RME252,49,42,9.38,91
1783930053,RAS301,30,63,9.17,93
1783930053,RVE301,28,46,9.17,74
1783930053,REE305,29,53,9.17,82
1783930053,REC301,30,53,9.17,83
1783930053,REC302,26,61,9.17,87
1783930053,REC303,30,55,9.17,85
1783930053,REC351,49,49,9.17,98
1783930053,REC352,44,39,9.17,83
1783930053,REC353,50,49,9.17,99
1783930053,REC354,45,45,9.17,90
1783930053,ROE047,30,53,8.92,83
1783930053,RAS402,25,44,8.92,69
1783930053,REC401,26,45,8.92,71
1783930053,REC402,30,57,8.92,87
1783930053,REC403,30,61,8.92,91
1783930053,RCS406,28,57,8.92,85
1783930053,REC451,45,47,8.92,92
1783930053,REC452,48,49,8.92,97
1783930053,REC453,47,49,8.92,96
1783930053,RCS456,50,45,8.92,95
1783930053,RAS501,30,42,8.71,72
1783930053,RAS502,30,56,8.71,86
1783930053,REC501A,30,59,8.71,89
1783930053,REC502,30,53,8.71,83
1783930053,REC503,30,49,8.71,79
1783930053,REC051,30,46,8.71,76
1783930053,REC551,46,42,8.71,88
1783930053,REC552,48,48,8.71,96
1783930053,REC553,49,48,8.71,97
1783930053,REC554,45,47,8.71,92
1783930053,RAS601,30,59,9.17,89
1783930053,RUC601,25,56,9.17,81
1783930053,RIC603,29,58,9.17,87
1783930053,REC601,28,58,9.17,86
1783930053,REC602,29,58,9.17,87
1783930053,REC064,30,59,9.17,89
1783930053,REC651,46,47,9.17,93
1783930053,REC652,49,48,9.17,97
1783930053,RIC653,48,47,9.17,95
1783930053,RIC651,47,47,9.17,94
1783930053,ROE072,28,39,8.67,67
1783930053,REC072,27,53,8.67,80
1783930053,REC075,27,64,8.67,91
1783930053,REC701,29,39,8.67,68
1783930053,REC702,27,56,8.67,83
1783930053,REC751,47,48,8.67,95
1783930053,REC752,42,48,8.67,90
1783930053,REC753,85,0,8.67,85
1783930053,REC754,165,0,8.67,165
1783930054,RAS301,18,40,6.63,58
1783930054,RVE301,18,45,6.63,63
1783930054,REE305,24,32,6.63,56
1783930054,REC301,26,31,6.63,57
1783930054,REC302,19,33,6.63,52
1783930054,REC303,17,44,6.63,61
1783930054,REC351,43,45,6.63,88
1783930054,REC352,36,38,6.63,74
1783930054,REC353,36,38,6.63,74
1783930054,REC354,38,37,6.63,75
1783930054,ROE047,27,37,7.54,64
1783930054,RAS402,24,50,7.54,74
1783930054,REC401,22,43,7.54,65
1783930054,REC402,20,35,7.54,55
1783930054,REC403,21,51,7.54,72
1783930054,RCS406,24,53,7.54,77
1783930054,REC451,40,42,7.54,82
1783930054,REC452,43,45,7.54,88
1783930054,REC453,42,46,7.54,88
1783930054,RCS456,44,40,7.54,84
1783930054,RAS101,20,39,6.83,59
1783930054,RAS102,20,49,6.83,69
1783930054,RAS103,20,45,6.83,65
1783930054,RME101,23,24,6.83,47
1783930054,RCS101,22,39,6.83,61
1783930054,RAS152,46,42,6.83,88
1783930054,RME151,43,44,6.83,87
1783930054,RCS151,42,46,6.83,88
1783930054,RCE151,40,39,6.83,79
1783930054,RAS203,24,40,6.96,64
1783930054,RAS201,16,46,6.96,62
1783930054,REE201,21,38,6.96,59
1783930054,RAS204,21,50,6.96,71
1783930054,REC201,16,26,6.96,42
1783930054,RAS251,42,47,6.96,89
1783930054,REE251,43,47,6.96,90
1783930054,RAS254,45,47,6.96,92
1783930054,RME252,43,41,6.96,84
1783930054,RAS501,28,42,6.67,70
1783930054,RAS502,24,53,6.67,77
1783930054,REC501A,17,40,6.67,57
1783930054,REC502,15,29,6.67,44
1783930054,REC503,15,48,6.67,63
1783930054,REC051,19,38,6.67,57
1783930054,REC551,33,35,6.67,68
1783930054,REC552,45,42,6.67,87
1783930054,REC553,39,41,6.67,80
1783930054,REC554,32,45,6.67,77
1783930054,RAS601,27,47,7.5,74
1783930054,RUC601,22,43,7.5,65
1783930054,RIC603,15,39,7.5,54
1783930054,REC601,27,47,7.5,74
1783930054,REC602,27,47,7.5,74
1783930054,REC064,15,39,7.5,54
1783930054,REC651,43,43,7.5,86
1783930054,REC652,49,45,7.5,94
1783930054,RIC653,39,42,7.5,81
1783930054,RIC651,40,42,7.5,82
1783930054,ROE072,22,38,7.04,60
1783930054,REC072,29,36,7.04,65
1783930054,REC075,27,39,7.04,66
1783930054,REC701,20,23,7.04,43
1783930054,REC702,22,39,7.04,61
1783930054,REC751,48,48,7.04,96
1783930054,REC752,42,48,7.04,90
1783930054,REC753,84,0,7.04,84
1783930054,REC754,150,0,7.04,150
1783930055,RAS101,26,46,7.42,72
1783930055,RAS102,19,49,7.42,68
1783930055,RAS103,21,48,7.42,69
1783930055,RME101,26,31,7.42,57
1783930055,RCS101,24,42,7.42,66
1783930055,RAS152,41,39,7.42,80
1783930055,RME151,45,44,7.42,89
1783930055,RCS151,44,40,7.42,84
1783930055,RCE151,41,39,7.42,80
1783930055,RAS203,25,27,7.33,52
1783930055,RAS201,19,44,7.33,63
1783930055,REE201,23,48,7.33,71
1783930055,RAS204,26,33,7.33,59
1783930055,REC201,22,41,7.33,63
1783930055,RAS251,44,45,7.33,89
1783930055,REE251,48,48,7.33,96
1783930055,RAS254,45,42,7.33,87
1783930055,RME252,48,40,7.33,88
1783930055,RAS301,23,50,7.88,73
1783930055,RVE301,19,55,7.88,74
1783930055,REE305,29,52,7.88,81
1783930055,REC301,25,40,7.88,65
1783930055,REC302,24,31,7.88,55
1783930055,REC303,20,50,7.88,70
1783930055,REC351,47,47,7.88,94
1783930055,REC352,40,42,7.88,82
1783930055,REC353,39,41,7.88,80
1783930055,REC354,41,47,7.88,88
1783930055,ROE047,29,44,7.54,73
1783930055,RAS402,22,36,7.54,58
1783930055,REC401,28,26,7.54,54
1783930055,REC402,25,51,7.54,76
1783930055,REC403,25,39,7.54,64
1783930055,RCS406,20,44,7.54,64
1783930055,REC451,45,45,7.54,90
1783930055,REC452,48,49,7.54,97
1783930055,REC453,48,49,7.54,97
1783930055,RCS456,47,40,7.54,87
1783930055,RAS501,30,43,7.71,73
1783930055,RAS502,23,48,7.71,71
1783930055,REC501A,22,48,7.71,70
1783930055,REC502,23,44,7.71,67
1783930055,REC503,20,52,7.71,72
1783930055,REC051,21,38,7.71,59
1783930055,REC551,46,45,7.71,91
1783930055,REC552,46,39,7.71,85
1783930055,REC553,39,39,7.71,78
1783930055,REC554,45,47,7.71,92
1783930055,RAS601,29,50,8.17,79
1783930055,RUC601,28,50,8.17,78
1783930055,RIC603,23,46,8.17,69
1783930055,REC601,29,50,8.17,79
1783930055,REC602,25,48,8.17,73
1783930055,REC064,25,48,8.17,73
1783930055,REC651,45,45,8.17,90
1783930055,REC652,48,45,8.17,93
1783930055,RIC653,44,44,8.17,88
1783930055,RIC651,45,45,8.17,90
1783930055,ROE072,29,41,8.13,70
1783930055,REC072,28,42,8.13,70
1783930055,REC075,28,40,8.13,68
1783930055,REC701,27,35,8.13,62
1783930055,REC702,28,44,8.13,72
1783930055,REC751,48,46,8.13,94
1783930055,REC752,45,46,8.13,91
1783930055,REC753,90,0,8.13,90
1783930055,REC754,175,0,8.13,175
1783930056,RAS101,22,50,7.92,72
1783930056,RAS102,22,52,7.92,74
1783930056,RAS103,22,58,7.92,80
1783930056,RME101,23,31,7.92,54
1783930056,RCS101,26,41,7.92,67
1783930056,RAS152,40,38,7.92,78
1783930056,RME151,43,47,7.92,90
1783930056,RCS151,46,41,7.92,87
1783930056,RCE151,42,39,7.92,81
1783930056,RAS203,30,40,7.92,70
1783930056,RAS201,20,56,7.92,76
1783930056,REE201,29,46,7.92,75
1783930056,RAS204,28,21,7.92,49
1783930056,REC201,23,47,7.92,70
1783930056,RAS251,44,44,7.92,88
1783930056,REE251,48,49,7.92,97
1783930056,RAS254,45,47,7.92,92
1783930056,RME252,42,42,7.92,84
1783930056,RAS301,26,53,7.46,79
1783930056,RVE301,18,31,7.46,49
1783930056,REE305,24,37,7.46,61
1783930056,REC301,26,53,7.46,79
1783930056,REC302,25,44,7.46,69
1783930056,REC303,28,32,7.46,60
1783930056,REC351,46,47,7.46,93
1783930056,REC352,36,44,7.46,80
1783930056,REC353,39,49,7.46,88
1783930056,REC354,44,46,7.46,90
1783930056,ROE047,24,47,8.29,71
1783930056,RAS402,19,54,8.29,73
1783930056,REC401,24,37,8.29,61
1783930056,REC402,25,55,8.29,80
1783930056,REC403,25,51,8.29,76
1783930056,RCS406,18,52,8.29,70
1783930056,REC451,46,42,8.29,88
1783930056,REC452,47,49,8.29,96
1783930056,REC453,44,46,8.29,90
1783930056,RCS456,47,41,8.29,88
1783930056,RAS501,28,32,8.0,60
1783930056,RAS502,23,56,8.0,79
1783930056,REC501A,22,39,8.0,61
1783930056,REC502,23,51,8.0,74
1783930056,REC503,25,56,8.0,81
1783930056,REC051,25,35,8.0,60
1783930056,REC551,44,38,8.0,82
1783930056,REC552,46,46,8.0,92
1783930056,REC553,48,47,8.0,95
1783930056,REC554,43,47,8.0,90
1783930056,RAS601,28,52,8.08,80
1783930056,RUC601,23,48,8.08,71
1783930056,RIC603,26,50,8.08,76
1783930056,REC601,27,51,8.08,78
1783930056,REC602,22,47,8.08,69
1783930056,REC064,19,45,8.08,64
1783930056,REC651,46,46,8.08,92
1783930056,REC652,43,45,8.08,88
1783930056,RIC653,46,46,8.08,92
1783930056,RIC651,38,43,8.08,81
1783930056,ROE072,26,37,7.96,63
1783930056,REC072,23,50,7.96,73
1783930056,REC075,24,44,7.96,68
1783930056,REC701,30,44,7.96,74
1783930056,REC702,25,41,7.96,66
1783930056,REC751,44,50,7.96,94
1783930056,REC752,42,50,7.96,92
1783930056,REC753,85,0,7.96,85
1783930056,REC754,170,0,7.96,170
1783930057,RAS101,25,47,8.04,72
1783930057,RAS102,22,48,8.04,70
1783930057,RAS103,23,58,8.04,81
1783930057,RME101,23,42,8.04,65
1783930057,RCS101,24,40,8.04,64
1783930057,RAS152,44,42,8.04,86
1783930057,RME151,43,47,8.04,90
1783930057,RCS151,44,40,8.04,84
1783930057,RCE151,40,39,8.04,79
1783930057,RAS203,28,42,7.5,70
1783930057,RAS201,21,40,7.5,61
1783930057,REE201,25,43,7.5,68
1783930057,RAS204,21,24,7.5,45
1783930057,REC201,17,53,7.5,70
1783930057,RAS251,44,46,7.5,90
1783930057,REE251,46,47,7.5,93
1783930057,RAS254,45,42,7.5,87
1783930057,RME252,40,35,7.5,75
1783930057,RAS301,18,30,7.0,48
1783930057,RVE301,19,50,7.0,69
1783930057,REE305,25,34,7.0,59
1783930057,REC301,23,47,7.0,70
1783930057,REC302,20,51,7.0,71
1783930057,REC303,16,46,7.0,62
1783930057,REC351,43,45,7.0,88
1783930057,REC352,34,35,7.0,69
1783930057,REC353,36,39,7.0,75
1783930057,REC354,39,40,7.0,79
1783930057,ROE047,12,32,5.38,44
1783930057,RAS402,21,21,5.38,42
1783930057,REC401,15,39,5.38,54
1783930057,REC402,11,32,5.38,43
1783930057,REC403,15,38,5.38,53
1783930057,RCS406,10,43,5.38,53
1783930057,REC451,35,35,5.38,70
1783930057,REC452,33,36,5.38,69
1783930057,REC453,37,41,5.38,78
1783930057,RCS456,35,36,5.38,71
1783930057,RAS501,22,39,4.67,61
1783930057,RAS502,21,41,4.67,62
1783930057,REC501A,13,23,4.67,36
1783930057,REC502,17,27,4.67,44
1783930057,REC503,11,25,4.67,36
1783930057,REC051,12,38,4.67,50
1783930057,REC551,31,36,4.67,67
1783930057,REC552,45,35,4.67,80
1783930057,REC553,33,35,4.67,68
1783930057,REC554,30,35,4.67,65
1783930057,RAS601,27,47,6.96,74
1783930057,RUC601,25,46,6.96,71
1783930057,RIC603,13,37,6.96,50
1783930057,REC601,17,40,6.96,57
1783930057,REC602,21,43,6.96,64
1783930057,REC064,15,39,6.96,54
1783930057,REC651,43,41,6.96,84
1783930057,REC652,43,41,6.96,84
1783930057,RIC653,30,37,6.96,67
1783930057,RIC651,30,37,6.96,67
1783930057,ROE072,24,37,7.08,61
1783930057,REC072,25,37,7.08,62
1783930057,REC075,25,33,7.08,58
1783930057,REC701,10,42,7.08,52
1783930057,REC702,19,43,7.08,62
1783930057,REC751,44,50,7.08,94
1783930057,REC752,32,50,7.08,82
1783930057,REC753,70,0,7.08,70
1783930057,REC754,140,0,7.08,140
1883930901,RAS301,13,34,6.17,47
1883930901,RVE301,16,25,6.17,41
1883930901,REE305,24,38,6.17,62
1883930901,REC301,21,23,6.17,44
1883930901,REC302,15,48,6.17,63
1883930901,REC303,15,56,6.17,71
1883930901,REC351,39,40,6.17,79
1883930901,REC352,42,34,6.17,76
1883930901,REC353,39,36,6.17,75
1883930901,REC354,31,33,6.17,64
1883930901,ROE047,21,34,6.25,55
1883930901,RAS402,16,30,6.25,46
1883930901,REC401,19,40,6.25,59
1883930901,REC402,16,42,6.25,58
1883930901,REC403,15,41,6.25,56
1883930901,RCS406,17,34,6.25,51
1883930901,REC451,39,37,6.25,76
1883930901,REC452,38,40,6.25,78
1883930901,REC453,37,39,6.25,76
1883930901,RCS456,41,39,6.25,80
1883930901,RAS501,25,48,6.92,73
1883930901,RAS502,21,54,6.92,75
1883930901,REC501A,15,38,6.92,53
1883930901,REC502,21,43,6.92,64
1883930901,REC503,13,45,6.92,58
1883930901,REC051,15,30,6.92,45
1883930901,REC551,36,35,6.92,71
1883930901,REC552,48,38,6.92,86
1883930901,REC553,37,37,6.92,74
1883930901,REC554,35,45,6.92,80
1883930901,RAS601,28,48,7.21,76
1883930901,RUC601,23,44,7.21,67
1883930901,RIC603,17,40,7.21,57
1883930901,REC601,19,41,7.21,60
1883930901,REC602,25,46,7.21,71
1883930901,REC064,18,41,7.21,59
1883930901,REC651,40,39,7.21,79
1883930901,REC652,45,41,7.21,86
1883930901,RIC653,41,39,7.21,80
1883930901,RIC651,33,37,7.21,70
1883930901,ROE072,27,39,7.42,66
1883930901,REC072,29,35,7.42,64
1883930901,REC075,27,50,7.42,77
1883930901,REC701,19,37,7.42,56
1883930901,REC702,27,39,7.42,66
1883930901,REC751,47,44,7.42,91
1883930901,REC752,40,44,7.42,84
1883930901,REC753,76,0,7.42,76
1883930901,REC754,145,0,7.42,145
1883930902,RAS301,14,21,4.58,35
1883930902,RVE301,16,25,4.58,41
1883930902,REE305,20,26,4.58,46
1883930902,REC301,12,36,4.58,48
1883930902,REC302,16,37,4.58,53
1883930902,REC303,15,25,4.58,40
1883930902,REC351,38,39,4.58,77
1883930902,REC352,40,35,4.58,75
1883930902,REC353,35,37,4.58,72
1883930902,REC354,37,39,4.58,76
1883930902,ROE047,24,25,4.38,49
1883930902,RAS402,15,26,4.38,41
1883930902,REC401,20,21,4.38,41
1883930902,REC402,14,30,4.38,44
1883930902,REC403,14,27,4.38,41
1883930902,RCS406,8,14,4.38,22
1883930902,REC451,40,37,4.38,77
1883930902,REC452,34,36,4.38,70
1883930902,REC453,39,41,4.38,80
1883930902,RCS456,30,42,4.38,72
1883930902,RAS501,24,40,6.25,64
1883930902,RAS502,21,36,6.25,57
1883930902,REC501A,17,36,6.25,53
1883930902,REC502,19,38,6.25,57
1883930902,REC503,11,34,6.25,45
1883930902,REC051,16,30,6.25,46
1883930902,REC551,34,47,6.25,81
1883930902,REC552,45,38,6.25,83
1883930902,REC553,38,38,6.25,76
1883930902,REC554,33,45,6.25,78
1883930902,RAS601,28,41,6.46,69
1883930902,RUC601,22,36,6.46,58
1883930902,RIC603,16,32,6.46,48
1883930902,REC601,19,34,6.46,53
1883930902,REC602,28,41,6.46,69
1883930902,REC064,15,32,6.46,47
1883930902,REC651,44,41,6.46,85
1883930902,REC652,48,42,6.46,90
1883930902,RIC653,40,40,6.46,80
1883930902,RIC651,38,39,6.46,77
1883930902,ROE072,23,31,6.88,54
1883930902,REC072,18,32,6.88,50
1883930902,REC075,20,38,6.88,58
1883930902,REC701,19,36,6.88,55
1883930902,REC702,20,31,6.88,51
1883930902,REC751,40,44,6.88,84
1883930902,REC752,40,44,6.88,84
1883930902,REC753,80,0,6.88,80
1883930902,REC754,175,0,6.88,175
1883930903,RAS301,21,28,6.96,49
1883930903,RVE301,16,47,6.96,63
1883930903,REE305,27,49,6.96,76
1883930903,REC301,23,29,6.96,52
1883930903,REC302,22,38,6.96,60
1883930903,REC303,20,46,6.96,66
1883930903,REC351,39,44,6.96,83
1883930903,REC352,44,42,6.96,86
1883930903,REC353,36,41,6.96,77
1883930903,REC354,40,45,6.96,85
1883930903,ROE047,29,46,7.17,75
1883930903,RAS402,24,38,7.17,62
1883930903,REC401,19,30,7.17,49
1883930903,REC402,17,43,7.17,60
1883930903,REC403,17,39,7.17,56
1883930903,RCS406,21,41,7.17,62
1883930903,REC451,41,40,7.17,81
1883930903,REC452,45,48,7.17,93
1883930903,REC453,41,43,7.17,84
1883930903,RCS456,41,43,7.17,84
1883930903,RAS501,29,38,7.5,67
1883930903,RAS502,23,46,7.5,69
1883930903,REC501A,18,45,7.5,63
1883930903,REC502,23,44,7.5,67
1883930903,REC503,22,47,7.5,69
1883930903,REC051,22,49,7.5,71
1883930903,REC551,38,45,7.5,83
1883930903,REC552,46,43,7.5,89
1883930903,REC553,42,42,7.5,84
1883930903,REC554,37,47,7.5,84
1883930903,RAS601,28,49,7.75,77
1883930903,RUC601,26,47,7.75,73
1883930903,RIC603,20,43,7.75,63
1883930903,REC601,21,44,7.75,65
1883930903,REC602,24,46,7.75,70
1883930903,REC064,18,42,7.75,60
1883930903,REC651,47,45,7.75,92
1883930903,REC652,45,45,7.75,90
1883930903,RIC653,41,43,7.75,84
1883930903,RIC651,30,40,7.75,70
1883930903,ROE072,23,45,7.75,68
1883930903,REC072,28,48,7.75,76
1883930903,REC075,26,46,7.75,72
1883930903,REC701,24,50,7.75,74
1883930903,REC702,21,37,7.75,58
1883930903,REC751,46,48,7.75,94
1883930903,REC752,39,48,7.75,87
1883930903,REC753,75,0,7.75,75
1883930903,REC754,150,0,7.75,150
1883930904,RAS301,22,46,7.25,68
1883930904,RVE301,17,38,7.25,55
1883930904,REE305,25,47,7.25,72
1883930904,REC301,23,46,7.25,69
1883930904,REC302,23,28,7.25,51
1883930904,REC303,24,46,7.25,70
1883930904,REC351,37,45,7.25,82
1883930904,REC352,40,35,7.25,75
1883930904,REC353,39,44,7.25,83
1883930904,REC354,39,45,7.25,84
1883930904,ROE047,26,43,7.08,69
1883930904,RAS402,21,49,7.08,70
1883930904,REC401,24,33,7.08,57
1883930904,REC402,24,45,7.08,69
1883930904,REC403,21,33,7.08,54
1883930904,RCS406,16,35,7.08,51
1883930904,REC451,41,40,7.08,81
1883930904,REC452,41,44,7.08,85
1883930904,REC453,42,44,7.08,86
1883930904,RCS456,44,42,7.08,86
1883930904,RAS501,25,36,7.13,61
1883930904,RAS502,29,40,7.13,69
1883930904,REC501A,25,37,7.13,62
1883930904,REC502,22,42,7.13,64
1883930904,REC503,28,41,7.13,69
1883930904,REC051,22,36,7.13,58
1883930904,REC551,39,40,7.13,79
1883930904,REC552,48,44,7.13,92
1883930904,REC553,45,44,7.13,89
1883930904,REC554,38,36,7.13,74
1883930904,RAS601,28,49,7.71,77
1883930904,RUC601,24,46,7.71,70
1883930904,RIC603,21,44,7.71,65
1883930904,REC601,21,44,7.71,65
1883930904,REC602,24,46,7.71,70
1883930904,REC064,22,44,7.71,66
1883930904,REC651,42,42,7.71,84
1883930904,REC652,45,43,7.71,88
1883930904,RIC653,44,42,7.71,86
1883930904,RIC651,42,42,7.71,84
1883930904,ROE072,25,31,7.33,56
1883930904,REC072,20,38,7.33,58
1883930904,REC075,25,53,7.33,78
1883930904,REC701,25,25,7.33,50
1883930904,REC702,25,43,7.33,68
1883930904,REC751,42,42,7.33,84
1883930904,REC752,45,42,7.33,87
1883930904,REC753,80,0,7.33,80
1883930904,REC754,170,0,7.33,170
1883930905,RAS301,22,33,6.75,55
1883930905,RVE301,14,31,6.75,45
1883930905,REE305,27,44,6.75,71
1883930905,REC301,21,35,6.75,56
1883930905,REC302,20,33,6.75,53
1883930905,REC303,22,51,6.75,73
1883930905,REC351,42,36,6.75,78
1883930905,REC352,38,34,6.75,72
1883930905,REC353,39,42,6.75,81
1883930905,REC354,33,42,6.75,75
1883930905,ROE047,24,30,7.08,54
1883930905,RAS402,17,44,7.08,61
1883930905,REC401,19,33,7.08,52
1883930905,REC402,23,51,7.08,74
1883930905,REC403,21,36,7.08,57
1883930905,RCS406,19,41,7.08,60
1883930905,REC451,40,40,7.08,80
1883930905,REC452,40,43,7.08,83
1883930905,REC453,43,46,7.08,89
1883930905,RCS456,41,41,7.08,82
1883930905,RAS501,25,37,7.63,62
1883930905,RAS502,22,41,7.63,63
1883930905,REC501A,22,42,7.63,64
1883930905,REC502,21,49,7.63,70
1883930905,REC503,20,45,7.63,65
1883930905,REC051,20,52,7.63,72
1883930905,REC551,40,36,7.63,76
1883930905,REC552,44,42,7.63,86
1883930905,REC553,41,41,7.63,82
1883930905,REC554,39,42,7.63,81
1883930905,RAS601,28,49,7.42,77
1883930905,RUC601,20,43,7.42,63
1883930905,RIC603,22,44,7.42,66
1883930905,REC601,21,44,7.42,65
1883930905,REC602,23,45,7.42,68
1883930905,REC064,19,42,7.42,61
1883930905,REC651,44,42,7.42,86
1883930905,REC652,45,43,7.42,88
1883930905,RIC653,44,42,7.42,86
1883930905,RIC651,33,39,7.42,72
1883930905,ROE072,24,35,7.46,59
1883930905,REC072,22,46,7.46,68
1883930905,REC075,24,46,7.46,70
1883930905,REC701,22,41,7.46,63
1883930905,REC702,24,40,7.46,64
1883930905,REC751,40,50,7.46,90
1883930905,REC752,36,50,7.46,86
1883930905,REC753,76,0,7.46,76
1883930905,REC754,150,0,7.46,150
1883930906,RAS301,19,41,6.92,60
1883930906,RVE301,15,31,6.92,46
1883930906,REE305,27,44,6.92,71
1883930906,REC301,22,27,6.92,49
1883930906,REC302,20,43,6.92,63
1883930906,REC303,24,45,6.92,69
1883930906,REC351,40,42,6.92,82
1883930906,REC352,46,42,6.92,88
1883930906,REC353,35,46,6.92,81
1883930906,REC354,35,40,6.92,75
1883930906,ROE047,20,31,6.29,51
1883930906,RAS402,22,46,6.29,68
1883930906,REC401,19,45,6.29,64
1883930906,REC402,16,26,6.29,42
1883930906,REC403,20,39,6.29,59
1883930906,RCS406,17,28,6.29,45
1883930906,REC451,39,42,6.29,81
1883930906,REC452,42,45,6.29,87
1883930906,REC453,39,41,6.29,80
1883930906,RCS456,47,42,6.29,89
1883930906,RAS501,29,43,7.21,72
1883930906,RAS502,22,46,7.21,68
1883930906,REC501A,17,49,7.21,66
1883930906,REC502,22,48,7.21,70
1883930906,REC503,13,48,7.21,61
1883930906,REC051,15,32,7.21,47
1883930906,REC551,42,35,7.21,77
1883930906,REC552,46,41,7.21,87
1883930906,REC553,35,40,7.21,75
1883930906,REC554,41,42,7.21,83
1883930906,RAS601,28,48,7.46,76
1883930906,RUC601,26,46,7.46,72
1883930906,RIC603,16,39,7.46,55
1883930906,REC601,25,46,7.46,71
1883930906,REC602,24,45,7.46,69
1883930906,REC064,18,41,7.46,59
1883930906,REC651,43,42,7.46,85
1883930906,REC652,45,43,7.46,88
1883930906,RIC653,41,41,7.46,82
1883930906,RIC651,40,41,7.46,81
1883930906,ROE072,24,42,8.0,66
1883930906,REC072,22,47,8.0,69
1883930906,REC075,25,52,8.0,77
1883930906,REC701,25,40,8.0,65
1883930906,REC702,25,46,8.0,71
1883930906,REC751,44,44,8.0,88
1883930906,REC752,40,44,8.0,84
1883930906,REC753,89,0,8.0,89
1883930906,REC754,180,0,8.0,180
1883930907,RAS301,18,31,6.33,49
1883930907,RVE301,16,46,6.33,62
1883930907,REE305,28,39,6.33,67
1883930907,REC301,23,31,6.33,54
1883930907,REC302,20,26,6.33,46
1883930907,REC303,20,31,6.33,51
1883930907,REC351,42,41,6.33,83
1883930907,REC352,36,36,6.33,72
1883930907,REC353,39,41,6.33,80
1883930907,REC354,37,39,6.33,76
1883930907,ROE047,27,47,6.58,74
1883930907,RAS402,21,33,6.58,54
1883930907,REC401,22,43,6.58,65
1883930907,REC402,16,25,6.58,41
1883930907,REC403,22,38,6.58,60
1883930907,RCS406,14,35,6.58,49
1883930907,REC451,42,37,6.58,79
1883930907,REC452,41,44,6.58,85
1883930907,REC453,40,42,6.58,82
1883930907,RCS456,44,41,6.58,85
1883930907,RAS501,27,48,7.38,75
1883930907,RAS502,26,46,7.38,72
1883930907,REC501A,22,37,7.38,59
1883930907,REC502,20,50,7.38,70
1883930907,REC503,12,48,7.38,60
1883930907,REC051,21,31,7.38,52
1883930907,REC551,39,40,7.38,79
1883930907,REC552,46,41,7.38,87
1883930907,REC553,37,40,7.38,77
1883930907,REC554,38,42,7.38,80
1883930907,RAS601,27,46,7.67,73
1883930907,RUC601,27,46,7.67,73
1883930907,RIC603,21,42,7.67,63
1883930907,REC601,21,42,7.67,63
1883930907,REC602,26,45,7.67,71
1883930907,REC064,22,42,7.67,64
1883930907,REC651,45,43,7.67,88
1883930907,REC652,46,43,7.67,89
1883930907,RIC653,40,41,7.67,81
1883930907,RIC651,35,40,7.67,75
1883930907,ROE072,23,31,7.58,54
1883930907,REC072,29,38,7.58,67
1883930907,REC075,27,40,7.58,67
1883930907,REC701,25,45,7.58,70
1883930907,REC702,27,46,7.58,73
1883930907,REC751,48,44,7.58,92
1883930907,REC752,41,44,7.58,85
1883930907,REC753,78,0,7.58,78
1883930907,REC754,150,0,7.58,150
1883930908,RAS301,20,40,7.54,60
1883930908,RVE301,20,41,7.54,61
1883930908,REE305,26,50,7.54,76
1883930908,REC301,24,54,7.54,78
1883930908,REC302,20,43,7.54,63
1883930908,REC303,22,39,7.54,61
1883930908,REC351,43,49,7.54,92
1883930908,REC352,40,36,7.54,76
1883930908,REC353,38,43,7.54,81
1883930908,REC354,35,40,7.54,75
1883930908,ROE047,29,47,7.71,76
1883930908,RAS402,23,41,7.71,64
1883930908,REC401,26,50,7.71,76
1883930908,REC402,19,36,7.71,55
1883930908,REC403,24,53,7.71,77
1883930908,RCS406,19,48,7.71,67
1883930908,REC451,45,45,7.71,90
1883930908,REC452,44,48,7.71,92
1883930908,REC453,44,46,7.71,90
1883930908,RCS456,44,39,7.71,83
1883930908,RAS501,26,48,8.42,74
1883930908,RAS502,24,61,8.42,85
1883930908,REC501A,22,41,8.42,63
1883930908,REC502,26,60,8.42,86
1883930908,REC503,21,61,8.42,82
1883930908,REC051,20,42,8.42,62
1883930908,REC551,44,47,8.42,91
1883930908,REC552,48,43,8.42,91
1883930908,REC553,42,42,8.42,84
1883930908,REC554,43,47,8.42,90
1883930908,RAS601,27,53,8.58,80
1883930908,RUC601,24,51,8.58,75
1883930908,RIC603,23,50,8.58,73
1883930908,REC601,27,53,8.58,80
1883930908,REC602,25,52,8.58,77
1883930908,REC064,21,49,8.58,70
1883930908,REC651,46,45,8.58,91
1883930908,REC652,46,45,8.58,91
1883930908,RIC653,43,44,8.58,87
1883930908,RIC651,46,45,8.58,91
1883930908,ROE072,27,39,8.25,66
1883930908,REC072,26,48,8.25,74
1883930908,REC075,27,40,8.25,67
1883930908,REC701,27,55,8.25,82
1883930908,REC702,27,45,8.25,72
1883930908,REC751,46,50,8.25,96
1883930908,REC752,43,50,8.25,93
1883930908,REC753,85,0,8.25,85
1883930908,REC754,170,0,8.25,170
1883930909,RAS301,15,32,7.17,47
1883930909,RVE301,16,48,7.17,64
1883930909,REE305,26,55,7.17,81
1883930909,REC301,24,46,7.17,70
1883930909,REC302,22,47,7.17,69
1883930909,REC303,15,43,7.17,58
1883930909,REC351,39,42,7.17,81
1883930909,REC352,40,39,7.17,79
1883930909,REC353,43,36,7.17,79
1883930909,REC354,35,47,7.17,82
1883930909,ROE047,29,46,7.96,75
1883930909,RAS402,25,49,7.96,74
1883930909,REC401,22,50,7.96,72
1883930909,REC402,16,44,7.96,60
1883930909,REC403,23,51,7.96,74
1883930909,RCS406,17,54,7.96,71
1883930909,REC451,40,37,7.96,77
1883930909,REC452,42,45,7.96,87
1883930909,REC453,39,41,7.96,80
1883930909,RCS456,47,40,7.96,87
1883930909,RAS501,28,33,8.21,61
1883930909,RAS502,23,53,8.21,76
1883930909,REC501A,23,57,8.21,80
1883930909,REC502,25,50,8.21,75
1883930909,REC503,23,56,8.21,79
1883930909,REC051,28,48,8.21,76
1883930909,REC551,45,40,8.21,85
1883930909,REC552,46,44,8.21,90
1883930909,REC553,42,44,8.21,86
1883930909,REC554,44,38,8.21,82
1883930909,RAS601,29,54,8.33,83
1883930909,RUC601,24,51,8.33,75
1883930909,RIC603,20,48,8.33,68
1883930909,REC601,23,50,8.33,73
1883930909,REC602,29,54,8.33,83
1883930909,REC064,22,49,8.33,71
1883930909,REC651,44,42,8.33,86
1883930909,REC652,48,43,8.33,91
1883930909,RIC653,42,42,8.33,84
1883930909,RIC651,43,42,8.33,85
1883930909,ROE072,25,40,8.08,65
1883930909,REC072,29,46,8.08,75
1883930909,REC075,28,42,8.08,70
1883930909,REC701,27,41,8.08,68
1883930909,REC702,28,49,8.08,77
1883930909,REC751,48,48,8.08,96
1883930909,REC752,42,50,8.08,92
1883930909,REC753,80,0,8.08,80
1883930909,REC754,175,0,8.08,175
1883930910,RAS301,22,28,6.96,50
1883930910,RVE301,21,42,6.96,63
1883930910,REE305,27,40,6.96,67
1883930910,REC301,22,44,6.96,66
1883930910,REC302,16,46,6.96,62
1883930910,REC303,16,40,6.96,56
1883930910,REC351,44,45,6.96,89
1883930910,REC352,36,38,6.96,74
1883930910,REC353,35,35,6.96,70
1883930910,REC354,35,45,6.96,80
1883930910,ROE047,29,45,7.46,74
1883930910,RAS402,23,35,7.46,58
1883930910,REC401,22,45,7.46,67
1883930910,REC402,19,38,7.46,57
1883930910,REC403,25,54,7.46,79
1883930910,RCS406,19,52,7.46,71
1883930910,REC451,43,37,7.46,80
1883930910,REC452,43,45,7.46,88
1883930910,REC453,42,42,7.46,84
1883930910,RCS456,47,42,7.46,89
1883930910,RAS501,30,47,8.13,77
1883930910,RAS502,25,54,8.13,79
1883930910,REC501A,21,60,8.13,81
1883930910,REC502,20,57,8.13,77
1883930910,REC503,13,55,8.13,68
1883930910,REC051,20,50,8.13,70
1883930910,REC551,37,47,8.13,84
1883930910,REC552,48,41,8.13,89
1883930910,REC553,35,40,8.13,75
1883930910,REC554,36,47,8.13,83
1883930910,RAS601,29,53,8.33,82
1883930910,RUC601,27,52,8.33,79
1883930910,RIC603,23,49,8.33,72
1883930910,REC601,25,51,8.33,76
1883930910,REC602,24,50,8.33,74
1883930910,REC064,22,48,8.33,70
1883930910,REC651,45,43,8.33,88
1883930910,REC652,47,43,8.33,90
1883930910,RIC653,42,42,8.33,84
1883930910,RIC651,45,43,8.33,88
1883930910,ROE072,25,44,8.08,69
1883930910,REC072,23,52,8.08,75
1883930910,REC075,22,49,8.08,71
1883930910,REC701,22,51,8.08,73
1883930910,REC702,25,41,8.08,66
1883930910,REC751,42,48,8.08,90
1883930910,REC752,36,48,8.08,84
1883930910,REC753,85,0,8.08,85
1883930910,REC754,170,0,8.08,170
1783910001,RAS101,18,37,6.58,55
1783910001,REC101,19,26,6.58,45
1783910001,RAS103,24,41,6.58,65
1783910001,REE101,18,37,6.58,55
1783910001,RAS104,19,39,6.58,58
1783910001,RAS151,38,40,6.58,78
1783910001,REE151,45,40,6.58,85
1783910001,RAS154,45,44,6.58,89
1783910001,RME152,41,43,6.58,84
1783910001,RAS203,24,38,6.71,62
1783910001,RAS201,29,39,6.71,68
1783910001,RME201,19,25,6.71,44
1783910001,RCS201,27,37,6.71,64
1783910001,RAS202,23,45,6.71,68
1783910001,RAS252,47,48,6.71,95
1783910001,RME251,30,35,6.71,65
1783910001,RCS251,45,44,6.71,89
1783910001,RCE251,33,34,6.71,67
1783910001,ROE037,23,37,7.0,60
1783910001,RAS302,23,37,7.0,60
1783910001,REC301,23,26,7.0,49
1783910001,RCS301,26,47,7.0,73
1783910001,RCS302,25,26,7.0,51
1783910001,RCS305,25,30,7.0,55
1783910001,REC351,42,46,7.0,88
1783910001,RCS351,45,48,7.0,93
1783910001,RCS352,45,44,7.0,89
1783910001,RCS355,44,47,7.0,91
1783910001,RAS401,16,37,6.33,53
1783910001,RVE401,24,26,6.33,50
1783910001,REC405,18,29,6.33,47
1783910001,RCS401,19,38,6.33,57
1783910001,RCS402,17,35,6.33,52
1783910001,RCS403,20,36,6.33,56
1783910001,RCS451,39,42,6.33,81
1783910001,RCS452,40,47,6.33,87
1783910001,RCS453,40,42,6.33,82
1783910001,RCS454,42,30,6.33,72
1783910001,RAS501,28,40,7.08,68
1783910001,RUC501,20,43,7.08,63
1783910001,RCS501,24,43,7.08,67
1783910001,RCS502,13,46,7.08,59
1783910001,RCS503,24,21,7.08,45
1783910001,RCS052,25,46,7.08,71
1783910001,RCS551,44,45,7.08,89
1783910001,RCS552,33,41,7.08,74
1783910001,RCS553,45,45,7.08,90
1783910001,RCS554,42,42,7.08,84
1783910001,RAS601,28,45,7.42,73
1783910001,RAS602,27,44,7.42,71
1783910001,RCS601,22,40,7.42,62
1783910001,RCS602,26,43,7.42,69
1783910001,RCS603,25,43,7.42,68
1783910001,RCS061,20,39,7.42,59
1783910001,RCS651,42,43,7.42,85
1783910001,RCS652,45,44,7.42,89
1783910001,RCS653,43,43,7.42,86
1783910001,RCS654,45,44,7.42,89
1783910001,ROE072,24,29,7.04,53
1783910001,RCS071,27,31,7.04,58
1783910001,RCS078,26,36,7.04,62
1783910001,RCS701,26,32,7.04,58
1783910001,RCS702,26,28,7.04,54
1783910001,RCS751,47,42,7.04,89
1783910001,RCS752,43,43,7.04,86
1783910001,RCS753,82,0,7.04,82
1783910001,RCS754,170,0,7.04,170
1783910002,RAS101,23,49,8.08,72
1783910002,REC101,27,51,8.08,78
1783910002,RAS103,29,54,8.08,83
1783910002,REE101,18,34,8.08,52
1783910002,RAS104,23,43,8.08,66
1783910002,RAS151,44,46,8.08,90
1783910002,REE151,46,42,8.08,88
1783910002,RAS154,46,48,8.08,94
1783910002,RME152,45,49,8.08,94
1783910002,RAS203,27,49,8.71,76
1783910002,RAS201,29,56,8.71,85
1783910002,RME201,26,50,8.71,76
1783910002,RCS201,29,42,8.71,71
1783910002,RAS202,29,55,8.71,84
1783910002,RAS252,49,48,8.71,97
1783910002,RME251,49,40,8.71,89
1783910002,RCS251,49,44,8.71,93
1783910002,RCE251,48,46,8.71,94
1783910002,ROE037,28,49,8.0,77
1783910002,RAS302,23,37,8.0,60
1783910002,REC301,29,34,8.0,63
1783910002,RCS301,22,51,8.0,73
1783910002,RCS302,26,28,8.0,54
1783910002,RCS305,25,57,8.0,82
1783910002,REC351,45,46,8.0,91
1783910002,RCS351,45,49,8.0,94
1783910002,RCS352,46,46,8.0,92
1783910002,RCS355,44,46,8.0,90
1783910002,RAS401,30,47,8.42,77
1783910002,RVE401,28,53,8.42,81
1783910002,REC405,28,47,8.42,75
1783910002,RCS401,25,51,8.42,76
1783910002,RCS402,23,52,8.42,75
1783910002,RCS403,25,46,8.42,71
1783910002,RCS451,45,46,8.42,91
1783910002,RCS452,46,47,8.42,93
1783910002,RCS453,45,43,8.42,88
1783910002,RCS454,47,46,8.42,93
1783910002,RAS501,30,54,8.71,84
1783910002,RUC501,24,52,8.71,76
1783910002,RCS501,29,56,8.71,85
1783910002,RCS502,18,45,8.71,63
1783910002,RCS503,27,48,8.71,75
1783910002,RCS052,30,60,8.71,90
1783910002,RCS551,50,49,8.71,99
1783910002,RCS552,42,47,8.71,89
1783910002,RCS553,48,49,8.71,97
1783910002,RCS554,50,50,8.71,100
1783910002,RAS601,29,54,8.83,83
1783910002,RAS602,28,54,8.83,82
1783910002,RCS601,22,49,8.83,71
1783910002,RCS602,29,54,8.83,83
1783910002,RCS603,29,54,8.83,83
1783910002,RCS061,22,49,8.83,71
1783910002,RCS651,37,44,8.83,81
1783910002,RCS652,49,48,8.83,97
1783910002,RCS653,48,47,8.83,95
1783910002,RCS654,46,47,8.83,93
1783910002,ROE072,29,51,8.75,80
1783910002,RCS071,22,41,8.75,63
1783910002,RCS078,28,49,8.75,77
1783910002,RCS701,29,58,8.75,87
1783910002,RCS702,28,51,8.75,79
1783910002,RCS751,49,42,8.75,91
1783910002,RCS752,47,46,8.75,93
1783910002,RCS753,90,0,8.75,90
1783910002,RCS754,180,0,8.75,180
1783910003,RAS101,21,51,7.75,72
1783910003,REC101,24,48,7.75,72
1783910003,RAS103,25,64,7.75,89
1783910003,REE101,17,24,7.75,41
1783910003,RAS104,24,51,7.75,75
1783910003,RAS151,40,42,7.75,82
1783910003,REE151,45,44,7.75,89
1783910003,RAS154,45,48,7.75,93
1783910003,RME152,45,43,7.75,88
1783910003,RAS203,23,31,7.63,54
1783910003,RAS201,24,38,7.63,62
1783910003,RME201,27,45,7.63,72
1783910003,RCS201,19,35,7.63,54
1783910003,RAS202,28,56,7.63,84
1783910003,RAS252,46,47,7.63,93
1783910003,RME251,43,41,7.63,84
1783910003,RCS251,38,40,7.63,78
1783910003,RCE251,44,44,7.63,88
1783910003,ROE037,22,40,6.42,62
1783910003,RAS302,17,44,6.42,61
1783910003,REC301,15,29,6.42,44
1783910003,RCS301,22,41,6.42,63
1783910003,RCS302,21,25,6.42,46
1783910003,RCS305,18,31,6.42,49
1783910003,REC351,40,45,6.42,85
1783910003,RCS351,43,45,6.42,88
1783910003,RCS352,40,41,6.42,81
1783910003,RCS355,45,46,6.42,91
1783910003,RAS401,5,9,4.46,14
1783910003,RVE401,23,39,4.46,62
1783910003,REC405,13,36,4.46,49
1783910003,RCS401,12,30,4.46,42
1783910003,RCS402,2,38,4.46,40
1783910003,RCS403,7,37,4.46,44
1783910003,RCS451,32,40,4.46,72
1783910003,RCS452,35,40,4.46,75
1783910003,RCS453,30,34,4.46,64
1783910003,RCS454,36,35,4.46,71
1783910003,RAS501,24,42,6.54,66
1783910003,RUC501,20,41,6.54,61
1783910003,RCS501,21,50,6.54,71
1783910003,RCS502,8,35,6.54,43
1783910003,RCS503,28,31,6.54,59
1783910003,RCS052,22,36,6.54,58
1783910003,RCS551,41,41,6.54,82
1783910003,RCS552,31,35,6.54,66
1783910003,RCS553,47,46,6.54,93
1783910003,RCS554,34,34,6.54,68
1783910003,RAS601,28,47,7.5,75
1783910003,RAS602,28,47,7.5,75
1783910003,RCS601,21,42,7.5,63
1783910003,RCS602,24,44,7.5,68
1783910003,RCS603,24,44,7.5,68
1783910003,RCS061,21,42,7.5,63
1783910003,RCS651,30,38,7.5,68
1783910003,RCS652,42,42,7.5,84
1783910003,RCS653,40,41,7.5,81
1783910003,RCS654,45,43,7.5,88
1783910003,ROE072,25,31,7.38,56
1783910003,RCS071,25,21,7.38,46
1783910003,RCS078,26,49,7.38,75
1783910003,RCS701,24,51,7.38,75
1783910003,RCS702,24,28,7.38,52
1783910003,RCS751,46,46,7.38,92
1783910003,RCS752,40,43,7.38,83
1783910003,RCS753,70,0,7.38,70
1783910003,RCS754,165,0,7.38,165
1783910004,RAS101,18,31,6.29,49
1783910004,REC101,20,32,6.29,52
1783910004,RAS103,21,48,6.29,69
1783910004,REE101,17,27,6.29,44
1783910004,RAS104,18,40,6.29,58
1783910004,RAS151,38,40,6.29,78
1783910004,REE151,45,39,6.29,84
1783910004,RAS154,45,48,6.29,93
1783910004,RME152,44,43,6.29,87
1783910004,RAS203,19,63,7.54,82
1783910004,RAS201,28,50,7.54,78
1783910004,RME201,19,44,7.54,63
1783910004,RCS201,15,51,7.54,66
1783910004,RAS202,15,51,7.54,66
1783910004,RAS252,38,40,7.54,78
1783910004,RME251,25,38,7.54,63
1783910004,RCS251,30,39,7.54,69
1783910004,RCE251,30,30,7.54,60
1783910004,ROE037,21,30,6.92,51
1783910004,RAS302,17,36,6.92,53
1783910004,REC301,23,42,6.92,65
1783910004,RCS301,20,61,6.92,81
1783910004,RCS302,19,30,6.92,49
1783910004,RCS305,21,33,6.92,54
1783910004,REC351,40,42,6.92,82
1783910004,RCS351,42,45,6.92,87
1783910004,RCS352,41,42,6.92,83
1783910004,RCS355,43,47,6.92,90
1783910004,RAS401,22,50,6.42,72
1783910004,RVE401,25,40,6.42,65
1783910004,REC405,21,23,6.42,44
1783910004,RCS401,17,50,6.42,67
1783910004,RCS402,14,29,6.42,43
1783910004,RCS403,20,28,6.42,48
1783910004,RCS451,37,40,6.42,77
1783910004,RCS452,41,41,6.42,82
1783910004,RCS453,47,48,6.42,95
1783910004,RCS454,43,44,6.42,87
1783910004,RAS501,23,33,6.83,56
1783910004,RUC501,24,43,6.83,67
1783910004,RCS501,25,50,6.83,75
1783910004,RCS502,9,36,6.83,45
1783910004,RCS503,24,35,6.83,59
1783910004,RCS052,23,46,6.83,69
1783910004,RCS551,45,45,6.83,90
1783910004,RCS552,30,33,6.83,63
1783910004,RCS553,46,46,6.83,92
1783910004,RCS554,35,36,6.83,71
1783910004,RAS601,28,49,7.75,77
1783910004,RAS602,28,49,7.75,77
1783910004,RCS601,16,40,7.75,56
1783910004,RCS602,24,46,7.75,70
1783910004,RCS603,24,46,7.75,70
1783910004,RCS061,18,42,7.75,60
1783910004,RCS651,39,41,7.75,80
1783910004,RCS652,44,42,7.75,86
1783910004,RCS653,41,41,7.75,82
1783910004,RCS654,45,43,7.75,88
1783910004,ROE072,25,29,7.33,54
1783910004,RCS071,24,32,7.33,56
1783910004,RCS078,26,36,7.33,62
1783910004,RCS701,26,45,7.33,71
1783910004,RCS702,24,29,7.33,53
1783910004,RCS751,47,43,7.33,90
1783910004,RCS752,40,41,7.33,81
1783910004,RCS753,72,0,7.33,72
1783910004,RCS754,168,0,7.33,168
1783910005,ROE037,20,45,6.67,65
1783910005,RAS302,21,32,6.67,53
1783910005,REC301,18,31,6.67,49
1783910005,RCS301,25,38,6.67,63
1783910005,RCS302,19,32,6.67,51
1783910005,RCS305,16,43,6.67,59
1783910005,REC351,42,36,6.67,78
1783910005,RCS351,44,48,6.67,92
1783910005,RCS352,40,41,6.67,81
1783910005,RCS355,43,46,6.67,89
1783910005,RAS401,18,34,6.58,52
1783910005,RVE401,27,43,6.58,70
1783910005,REC405,14,35,6.58,49
1783910005,RCS401,14,42,6.58,56
1783910005,RCS402,18,33,6.58,51
1783910005,RCS403,20,31,6.58,51
1783910005,RCS451,34,40,6.58,74
1783910005,RCS452,38,41,6.58,79
1783910005,RCS453,47,47,6.58,94
1783910005,RCS454,40,40,6.58,80
1783910005,RAS101,18,51,6.29,69
1783910005,REC101,19,25,6.29,44
1783910005,RAS103,21,32,6.29,53
1783910005,REE101,17,25,6.29,42
1783910005,RAS104,27,42,6.29,69
1783910005,RAS151,37,39,6.29,76
1783910005,REE151,45,48,6.29,93
1783910005,RAS154,45,48,6.29,93
1783910005,RME152,42,44,6.29,86
1783910005,RAS203,19,56,6.92,75
1783910005,RAS201,16,41,6.92,57
1783910005,RME201,20,39,6.92,59
1783910005,RCS201,21,35,6.92,56
1783910005,RAS202,15,53,6.92,68
1783910005,RAS252,38,41,6.92,79
1783910005,RME251,29,32,6.92,61
1783910005,RCS251,42,42,6.92,84
1783910005,RCE251,39,37,6.92,76
1783910005,RAS501,23,36,7.13,59
1783910005,RUC501,24,55,7.13,79
1783910005,RCS501,22,43,7.13,65
1783910005,RCS502,9,44,7.13,53
1783910005,RCS503,23,28,7.13,51
1783910005,RCS052,24,46,7.13,70
1783910005,RCS551,42,42,7.13,84
1783910005,RCS552,30,33,7.13,63
1783910005,RCS553,46,46,7.13,92
1783910005,RCS554,36,39,7.13,75
1783910005,RAS601,28,47,7.38,75
1783910005,RAS602,28,47,7.38,75
1783910005,RCS601,16,38,7.38,54
1783910005,RCS602,24,44,7.38,68
1783910005,RCS603,24,44,7.38,68
1783910005,RCS061,23,43,7.38,66
1783910005,RCS651,30,38,7.38,68
1783910005,RCS652,42,42,7.38,84
1783910005,RCS653,40,41,7.38,81
1783910005,RCS654,46,43,7.38,89
1783910005,ROE072,27,32,7.75,59
1783910005,RCS071,27,34,7.75,61
1783910005,RCS078,26,35,7.75,61
1783910005,RCS701,27,54,7.75,81
1783910005,RCS702,24,43,7.75,67
1783910005,RCS751,48,42,7.75,90
1783910005,RCS752,40,41,7.75,81
1783910005,RCS753,74,0,7.75,74
1783910005,RCS754,167,0,7.75,167
1783910006,RAS101,18,60,7.63,78
1783910006,REC101,21,41,7.63,62
1783910006,RAS103,26,58,7.63,84
1783910006,REE101,18,37,7.63,55
1783910006,RAS104,24,26,7.63,50
1783910006,RAS151,36,38,7.63,74
1783910006,REE151,44,44,7.63,88
1783910006,RAS154,44,47,7.63,91
1783910006,RME152,43,43,7.63,86
1783910006,RAS203,22,42,7.46,64
1783910006,RAS201,22,42,7.46,64
1783910006,RME201,25,63,7.46,88
1783910006,RCS201,29,40,7.46,69
1783910006,RAS202,24,34,7.46,58
1783910006,RAS252,42,44,7.46,86
1783910006,RME251,48,40,7.46,88
1783910006,RCS251,49,45,7.46,94
1783910006,RCE251,34,35,7.46,69
1783910006,ROE037,20,47,6.92,67
1783910006,RAS302,21,28,6.92,49
1783910006,REC301,21,31,6.92,52
1783910006,RCS301,20,47,6.92,67
1783910006,RCS302,29,27,6.92,56
1783910006,RCS305,26,34,6.92,60
1783910006,REC351,43,46,6.92,89
1783910006,RCS351,43,45,6.92,88
1783910006,RCS352,46,45,6.92,91
1783910006,RCS355,46,47,6.92,93
1783910006,RAS401,21,46,6.75,67
1783910006,RVE401,28,36,6.75,64
1783910006,REC405,19,34,6.75,53
1783910006,RCS401,30,45,6.75,75
1783910006,RCS402,17,28,6.75,45
1783910006,RCS403,23,24,6.75,47
1783910006,RCS451,50,44,6.75,94
1783910006,RCS452,37,41,6.75,78
1783910006,RCS453,48,49,6.75,97
1783910006,RCS454,37,40,6.75,77
1783910007,RAS101,20,41,7.38,61
1783910007,REC101,21,45,7.38,66
1783910007,RAS103,26,54,7.38,80
1783910007,REE101,18,40,7.38,58
1783910007,RAS104,21,27,7.38,48
1783910007,RAS151,39,41,7.38,80
1783910007,REE151,48,42,7.38,90
1783910007,RAS154,48,38,7.38,86
1783910007,RME152,42,44,7.38,86
1783910007,RAS203,24,49,7.54,73
1783910007,RAS201,28,46,7.54,74
1783910007,RME201,24,38,7.54,62
1783910007,RCS201,27,37,7.54,64
1783910007,RAS202,18,39,7.54,57
1783910007,RAS252,40,43,7.54,83
1783910007,RME251,40,37,7.54,77
1783910007,RCS251,46,39,7.54,85
1783910007,RCE251,41,42,7.54,83
1783910007,ROE037,20,51,6.88,71
1783910007,RAS302,17,35,6.88,52
1783910007,REC301,15,25,6.88,40
1783910007,RCS301,19,46,6.88,65
1783910007,RCS302,18,42,6.88,60
1783910007,RCS305,25,27,6.88,52
1783910007,REC351,44,45,6.88,89
1783910007,RCS351,43,47,6.88,90
1783910007,RCS352,38,41,6.88,79
1783910007,RCS355,44,48,6.88,92
1783910007,RAS401,17,32,6.0,49
1783910007,RVE401,28,44,6.0,72
1783910007,REC405,13,36,6.0,49
1783910007,RCS401,14,45,6.0,59
1783910007,RCS402,19,35,6.0,54
1783910007,RCS403,19,21,6.0,40
1783910007,RCS451,33,42,6.0,75
1783910007,RCS452,37,41,6.0,78
1783910007,RCS453,40,42,6.0,82
1783910007,RCS454,36,40,6.0,76
1783910007,RAS501,23,42,7.0,65
1783910007,RUC501,21,47,7.0,68
1783910007,RCS501,22,39,7.0,61
1783910007,RCS502,3,44,7.0,47
1783910007,RCS503,24,53,7.0,77
1783910007,RCS052,22,38,7.0,60
1783910007,RCS551,42,42,7.0,84
1783910007,RCS552,30,33,7.0,63
1783910007,RCS553,46,45,7.0,91
1783910007,RCS554,34,33,7.0,67
1783910007,RAS601,28,48,7.33,76
1783910007,RAS602,27,47,7.33,74
1783910007,RCS601,14,38,7.33,52
1783910007,RCS602,20,42,7.33,62
1783910007,RCS603,24,45,7.33,69
1783910007,RCS061,20,42,7.33,62
1783910007,RCS651,30,38,7.33,68
1783910007,RCS652,36,40,7.33,76
1783910007,RCS653,40,41,7.33,81
1783910007,RCS654,46,43,7.33,89
1783910007,ROE072,27,38,7.71,65
1783910007,RCS071,27,35,7.71,62
1783910007,RCS078,25,37,7.71,62
1783910007,RCS701,25,41,7.71,66
1783910007,RCS702,22,48,7.71,70
1783910007,RCS751,46,47,7.71,93
1783910007,RCS752,37,41,7.71,78
1783910007,RCS753,80,0,7.71,80
1783910007,RCS754,170,0,7.71,170
1783910008,RAS101,22,42,7.17,64
1783910008,REC101,26,37,7.17,63
1783910008,RAS103,23,41,7.17,64
1783910008,REE101,17,42,7.17,59
1783910008,RAS104,21,36,7.17,57
1783910008,RAS151,43,43,7.17,86
1783910008,REE151,42,42,7.17,84
1783910008,RAS154,42,48,7.17,90
1783910008,RME152,46,43,7.17,89
1783910008,RAS203,23,42,7.25,65
1783910008,RAS201,27,26,7.25,53
1783910008,RME201,28,27,7.25,55
1783910008,RCS201,21,34,7.25,55
1783910008,RAS202,27,43,7.25,70
1783910008,RAS252,45,47,7.25,92
1783910008,RME251,48,40,7.25,88
1783910008,RCS251,43,41,7.25,84
1783910008,RCE251,46,45,7.25,91
1783910008,ROE037,24,50,7.21,74
1783910008,RAS302,17,44,7.21,61
1783910008,REC301,24,39,7.21,63
1783910008,RCS301,26,31,7.21,57
1783910008,RCS302,27,24,7.21,51
1783910008,RCS305,26,25,7.21,51
1783910008,REC351,42,42,7.21,84
1783910008,RCS351,46,48,7.21,94
1783910008,RCS352,45,46,7.21,91
1783910008,RCS355,46,48,7.21,94
1783910008,RAS401,25,51,6.83,76
1783910008,RVE401,28,41,6.83,69
1783910008,REC405,19,30,6.83,49
1783910008,RCS401,23,44,6.83,67
1783910008,RCS402,22,31,6.83,53
1783910008,RCS403,19,29,6.83,48
1783910008,RCS451,43,46,6.83,89
1783910008,RCS452,46,42,6.83,88
1783910008,RCS453,40,42,6.83,82
1783910008,RCS454,45,48,6.83,93
1783910008,RAS501,27,54,8.08,81
1783910008,RUC501,23,56,8.08,79
1783910008,RCS501,25,49,8.08,74
1783910008,RCS502,16,48,8.08,64
1783910008,RCS503,30,48,8.08,78
1783910008,RCS052,27,39,8.08,66
1783910008,RCS551,47,48,8.08,95
1783910008,RCS552,42,45,8.08,87
1783910008,RCS553,50,49,8.08,99
1783910008,RCS554,47,43,8.08,90
1783910008,RAS601,28,48,8.0,76
1783910008,RAS602,28,48,8.0,76
1783910008,RCS601,21,43,8.0,64
1783910008,RCS602,30,49,8.0,79
1783910008,RCS603,29,48,8.0,77
1783910008,RCS061,22,43,8.0,65
1783910008,RCS651,40,44,8.0,84
1783910008,RCS652,49,47,8.0,96
1783910008,RCS653,49,47,8.0,96
1783910008,RCS654,49,47,8.0,96
1783910008,ROE072,25,35,8.04,60
1783910008,RCS071,24,37,8.04,61
1783910008,RCS078,28,39,8.04,67
1783910008,RCS701,29,50,8.04,79
1783910008,RCS702,29,35,8.04,64
1783910008,RCS751,49,41,8.04,90
1783910008,RCS752,48,47,8.04,95
1783910008,RCS753,90,0,8.04,90
1783910008,RCS754,180,0,8.04,180
1783910009,RAS101,19,34,7.25,53
1783910009,REC101,19,29,7.25,48
1783910009,RAS103,24,54,7.25,78
1783910009,REE101,18,52,7.25,70
1783910009,RAS104,22,41,7.25,63
1783910009,RAS151,40,42,7.25,82
1783910009,REE151,45,42,7.25,87
1783910009,RAS154,45,44,7.25,89
1783910009,RME152,41,44,7.25,85
1783910009,RAS203,20,36,7.21,56
1783910009,RAS201,17,33,7.21,50
1783910009,RME201,25,40,7.21,65
1783910009,RCS201,19,42,7.21,61
1783910009,RAS202,24,47,7.21,71
1783910009,RAS252,42,43,7.21,85
1783910009,RME251,45,42,7.21,87
1783910009,RCS251,38,40,7.21,78
1783910009,RCE251,42,43,7.21,85
1783910009,ROE037,23,48,7.17,71
1783910009,RAS302,18,45,7.17,63
1783910009,REC301,21,32,7.17,53
1783910009,RCS301,22,50,7.17,72
1783910009,RCS302,21,25,7.17,46
1783910009,RCS305,21,35,7.17,56
1783910009,REC351,47,48,7.17,95
1783910009,RCS351,44,45,7.17,89
1783910009,RCS352,41,42,7.17,83
1783910009,RCS355,46,47,7.17,93
1783910009,RAS401,25,57,7.54,82
1783910009,RVE401,28,35,7.54,63
1783910009,REC405,28,49,7.54,77
1783910009,RCS401,23,41,7.54,64
1783910009,RCS402,17,39,7.54,56
1783910009,RCS403,23,34,7.54,57
1783910009,RCS451,43,41,7.54,84
1783910009,RCS452,44,43,7.54,87
1783910009,RCS453,48,48,7.54,96
1783910009,RCS454,43,46,7.54,89
1783910009,RAS501,27,36,6.83,63
1783910009,RUC501,20,36,6.83,56
1783910009,RCS501,23,45,6.83,68
1783910009,RCS502,8,49,6.83,57
1783910009,RCS503,24,30,6.83,54
1783910009,RCS052,23,39,6.83,62
1783910009,RCS551,43,43,6.83,86
1783910009,RCS552,30,33,6.83,63
1783910009,RCS553,46,46,6.83,92
1783910009,RCS554,35,40,6.83,75
1783910009,RAS601,28,49,8.0,77
1783910009,RAS602,28,49,8.0,77
1783910009,RCS601,22,44,8.0,66
1783910009,RCS602,29,49,8.0,78
1783910009,RCS603,27,48,8.0,75
1783910009,RCS061,19,42,8.0,61
1783910009,RCS651,44,44,8.0,88
1783910009,RCS652,48,45,8.0,93
1783910009,RCS653,47,45,8.0,92
1783910009,RCS654,46,45,8.0,91
1783910009,ROE072,24,51,8.08,75
1783910009,RCS071,25,34,8.08,59
1783910009,RCS078,27,46,8.08,73
1783910009,RCS701,26,46,8.08,72
1783910009,RCS702,24,46,8.08,70
1783910009,RCS751,46,44,8.08,90
1783910009,RCS752,40,43,8.08,83
1783910009,RCS753,88,0,8.08,88
1783910009,RCS754,178,0,8.08,178
1783910010,RAS101,25,62,8.79,87
1783910010,REC101,27,39,8.79,66
1783910010,RAS103,30,63,8.79,93
1783910010,REE101,19,60,8.79,79
1783910010,RAS104,23,59,8.79,82
1783910010,RAS151,42,44,8.79,86
1783910010,REE151,46,42,8.79,88
1783910010,RAS154,46,48,8.79,94
1783910010,RME152,45,48,8.79,93
1783910010,RAS203,23,27,7.29,50
1783910010,RAS201,27,39,7.29,66
1783910010,RME201,25,39,7.29,64
1783910010,RCS201,23,43,7.29,66
1783910010,RAS202,24,39,7.29,63
1783910010,RAS252,46,47,7.29,93
1783910010,RME251,43,39,7.29,82
1783910010,RCS251,43,45,7.29,88
1783910010,RCE251,40,41,7.29,81
1783910010,ROE037,27,51,8.0,78
1783910010,RAS302,26,56,8.0,82
1783910010,REC301,30,41,8.0,71
1783910010,RCS301,27,61,8.0,88
1783910010,RCS302,27,42,8.0,69
1783910010,RCS305,25,33,8.0,58
1783910010,REC351,48,48,8.0,96
1783910010,RCS351,46,45,8.0,91
1783910010,RCS352,42,31,8.0,73
1783910010,RCS355,42,42,8.0,84
1783910010,RAS401,24,47,7.29,71
1783910010,RVE401,23,47,7.29,70
1783910010,REC405,18,39,7.29,57
1783910010,RCS401,18,49,7.29,67
1783910010,RCS402,16,30,7.29,46
1783910010,RCS403,25,38,7.29,63
1783910010,RCS451,38,42,7.29,80
1783910010,RCS452,39,47,7.29,86
1783910010,RCS453,48,49,7.29,97
1783910010,RCS454,39,41,7.29,80
1783910010,RAS501,30,32,7.5,62
1783910010,RUC501,19,52,7.5,71
1783910010,RCS501,25,51,7.5,76
1783910010,RCS502,16,47,7.5,63
1783910010,RCS503,24,44,7.5,68
1783910010,RCS052,26,32,7.5,58
1783910010,RCS551,45,46,7.5,91
1783910010,RCS552,42,45,7.5,87
1783910010,RCS553,46,46,7.5,92
1783910010,RCS554,44,42,7.5,86
1783910010,RAS601,27,51,8.17,78
1783910010,RAS602,28,52,8.17,80
1783910010,RCS601,20,46,8.17,66
1783910010,RCS602,27,51,8.17,78
1783910010,RCS603,26,50,8.17,76
1783910010,RCS061,24,49,8.17,73
1783910010,RCS651,30,40,8.17,70
1783910010,RCS652,44,44,8.17,88
1783910010,RCS653,40,43,8.17,83
1783910010,RCS654,45,45,8.17,90
1783910010,ROE072,27,32,8.08,59
1783910010,RCS071,25,45,8.08,70
1783910010,RCS078,26,45,8.08,71
1783910010,RCS701,26,57,8.08,83
1783910010,RCS702,24,35,8.08,59
1783910010,RCS751,46,47,8.08,93
1783910010,RCS752,40,43,8.08,83
1783910010,RCS753,90,0,8.08,90
1783910010,RCS754,177,0,8.08,177
1783910011,RAS101,21,50,8.21,71
1783910011,REC101,25,41,8.21,66
1783910011,RAS103,25,51,8.21,76
1783910011,REE101,20,54,8.21,74
1783910011,RAS104,24,47,8.21,71
1783910011,RAS151,40,42,8.21,82
1783910011,REE151,46,44,8.21,90
1783910011,RAS154,46,44,8.21,90
1783910011,RME152,45,46,8.21,91
1783910011,RAS203,24,63,7.75,87
1783910011,RAS201,15,44,7.75,59
1783910011,RME201,24,46,7.75,70
1783910011,RCS201,20,39,7.75,59
1783910011,RAS202,28,35,7.75,63
1783910011,RAS252,45,46,7.75,91
1783910011,RME251,46,41,7.75,87
1783910011,RCS251,42,43,7.75,85
1783910011,RCE251,46,45,7.75,91
1783910011,ROE037,25,45,6.88,70
1783910011,RAS302,21,47,6.88,68
1783910011,REC301,21,27,6.88,48
1783910011,RCS301,21,44,6.88,65
1783910011,RCS302,25,31,6.88,56
1783910011,RCS305,19,28,6.88,47
1783910011,REC351,41,48,6.88,89
1783910011,RCS351,45,46,6.88,91
1783910011,RCS352,43,44,6.88,87
1783910011,RCS355,44,47,6.88,91
1783910011,RAS401,18,51,7.13,69
1783910011,RVE401,30,45,7.13,75
1783910011,REC405,23,34,7.13,57
1783910011,RCS401,22,49,7.13,71
1783910011,RCS402,17,32,7.13,49
1783910011,RCS403,24,27,7.13,51
1783910011,RCS451,42,44,7.13,86
1783910011,RCS452,44,41,7.13,85
1783910011,RCS453,48,47,7.13,95
1783910011,RCS454,45,47,7.13,92
1783910011,RAS501,29,45,7.5,74
1783910011,RUC501,22,53,7.5,75
1783910011,RCS501,25,50,7.5,75
1783910011,RCS502,14,26,7.5,40
1783910011,RCS503,24,30,7.5,54
1783910011,RCS052,27,53,7.5,80
1783910011,RCS551,45,45,7.5,90
1783910011,RCS552,35,38,7.5,73
1783910011,RCS553,46,46,7.5,92
1783910011,RCS554,47,45,7.5,92
1783910011,RAS601,28,50,8.04,78
1783910011,RAS602,28,50,8.04,78
1783910011,RCS601,20,44,8.04,64
1783910011,RCS602,28,50,8.04,78
1783910011,RCS603,23,46,8.04,69
1783910011,RCS061,24,47,8.04,71
1783910011,RCS651,45,46,8.04,91
1783910011,RCS652,48,46,8.04,94
1783910011,RCS653,38,43,8.04,81
1783910011,RCS654,47,46,8.04,93
1783910011,ROE072,27,49,8.42,76
1783910011,RCS071,27,50,8.42,77
1783910011,RCS078,26,48,8.42,74
1783910011,RCS701,26,47,8.42,73
1783910011,RCS702,26,55,8.42,81
1783910011,RCS751,46,43,8.42,89
1783910011,RCS752,43,46,8.42,89
1783910011,RCS753,86,0,8.42,86
1783910011,RCS754,176,0,8.42,176
1783910012,RAS101,21,41,7.08,62
1783910012,REC101,23,30,7.08,53
1783910012,RAS103,22,50,7.08,72
1783910012,REE101,16,29,7.08,45
1783910012,RAS104,19,42,7.08,61
1783910012,RAS151,41,43,7.08,84
1783910012,REE151,42,40,7.08,82
1783910012,RAS154,42,40,7.08,82
1783910012,RME152,44,43,7.08,87
1783910012,RAS203,24,38,6.88,62
1783910012,RAS201,15,30,6.88,45
1783910012,RME201,23,42,6.88,65
1783910012,RCS201,19,40,6.88,59
1783910012,RAS202,24,41,6.88,65
1783910012,RAS252,44,43,6.88,87
1783910012,RME251,45,33,6.88,78
1783910012,RCS251,39,40,6.88,79
1783910012,RCE251,44,44,6.88,88
1783910012,ROE037,22,39,7.33,61
1783910012,RAS302,20,45,7.33,65
1783910012,REC301,19,41,7.33,60
1783910012,RCS301,24,42,7.33,66
1783910012,RCS302,24,23,7.33,47
1783910012,RCS305,19,51,7.33,70
1783910012,REC351,47,43,7.33,90
1783910012,RCS351,42,50,7.33,92
1783910012,RCS352,43,45,7.33,88
1783910012,RCS355,43,46,7.33,89
1783910012,RAS401,18,25,5.92,43
1783910012,RVE401,28,43,5.92,71
1783910012,REC405,19,32,5.92,51
1783910012,RCS401,23,35,5.92,58
1783910012,RCS402,21,21,5.92,42
1783910012,RCS403,21,21,5.92,42
1783910012,RCS451,43,43,5.92,86
1783910012,RCS452,44,47,5.92,91
1783910012,RCS453,47,47,5.92,94
1783910012,RCS454,45,40,5.92,85
1783910012,RAS501,25,38,6.42,63
1783910012,RUC501,23,47,6.42,70
1783910012,RCS501,24,38,6.42,62
1783910012,RCS502,9,22,6.42,31
1783910012,RCS503,24,35,6.42,59
1783910012,RCS052,26,56,6.42,82
1783910012,RCS551,44,44,6.42,88
1783910012,RCS552,30,33,6.42,63
1783910012,RCS553,46,46,6.42,92
1783910012,RCS554,40,37,6.42,77
1783910012,RAS601,29,47,7.5,76
1783910012,RAS602,29,47,7.5,76
1783910012,RCS601,16,38,7.5,54
1783910012,RCS602,27,46,7.5,73
1783910012,RCS603,22,42,7.5,64
1783910012,RCS061,19,40,7.5,59
1783910012,RCS651,47,44,7.5,91
1783910012,RCS652,44,43,7.5,87
1783910012,RCS653,36,41,7.5,77
1783910012,RCS654,46,44,7.5,90
1783910012,ROE072,23,38,7.38,61
1783910012,RCS071,25,33,7.38,58
1783910012,RCS078,25,35,7.38,60
1783910012,RCS701,25,41,7.38,66
1783910012,RCS702,26,36,7.38,62
1783910012,RCS751,45,42,7.38,87
1783910012,RCS752,43,43,7.38,86
1783910012,RCS753,72,0,7.38,72
1783910012,RCS754,167,0,7.38,167
1783910013,RAS101,21,42,7.17,63
1783910013,REC101,24,26,7.17,50
1783910013,RAS103,19,32,7.17,51
1783910013,REE101,16,45,7.17,61
1783910013,RAS104,19,46,7.17,65
1783910013,RAS151,42,44,7.17,86
1783910013,REE151,43,40,7.17,83
1783910013,RAS154,43,45,7.17,88
1783910013,RME152,45,45,7.17,90
1783910013,RAS203,15,30,5.17,45
1783910013,RAS201,15,23,5.17,38
1783910013,RME201,22,34,5.17,56
1783910013,RCS201,19,30,5.17,49
1783910013,RAS202,23,25,5.17,48
1783910013,RAS252,44,46,5.17,90
1783910013,RME251,41,35,5.17,76
1783910013,RCS251,37,43,5.17,80
1783910013,RCE251,42,43,5.17,85
1783910013,ROE037,20,33,6.58,53
1783910013,RAS302,16,41,6.58,57
1783910013,REC301,16,35,6.58,51
1783910013,RCS301,24,48,6.58,72
1783910013,RCS302,14,38,6.58,52
1783910013,RCS305,20,28,6.58,48
1783910013,REC351,44,36,6.58,80
1783910013,RCS351,45,46,6.58,91
1783910013,RCS352,33,35,6.58,68
1783910013,RCS355,43,47,6.58,90
1783910013,RAS401,11,29,5.54,40
1783910013,RVE401,28,28,5.54,56
1783910013,REC405,15,31,5.54,46
1783910013,RCS401,16,41,5.54,57
1783910013,RCS402,13,35,5.54,48
1783910013,RCS403,15,27,5.54,42
1783910013,RCS451,36,45,5.54,81
1783910013,RCS452,38,47,5.54,85
1783910013,RCS453,40,42,5.54,82
1783910013,RCS454,40,39,5.54,79
1783910013,RAS501,23,44,6.0,67
1783910013,RUC501,24,41,6.0,65
1783910013,RCS501,21,42,6.0,63
1783910013,RCS502,12,21,6.0,33
1783910013,RCS503,25,25,6.0,50
1783910013,RCS052,26,41,6.0,67
1783910013,RCS551,41,41,6.0,82
1783910013,RCS552,30,34,6.0,64
1783910013,RCS553,46,46,6.0,92
1783910013,RCS554,40,42,6.0,82
1783910013,RAS601,26,43,7.33,69
1783910013,RAS602,26,43,7.33,69
1783910013,RCS601,20,39,7.33,59
1783910013,RCS602,28,45,7.33,73
1783910013,RCS603,25,43,7.33,68
1783910013,RCS061,22,40,7.33,62
1783910013,RCS651,34,40,7.33,74
1783910013,RCS652,46,44,7.33,90
1783910013,RCS653,38,41,7.33,79
1783910013,RCS654,45,44,7.33,89
1783910013,ROE072,23,31,7.38,54
1783910013,RCS071,26,46,7.38,72
1783910013,RCS078,27,42,7.38,69
1783910013,RCS701,27,38,7.38,65
1783910013,RCS702,24,21,7.38,45
1783910013,RCS751,48,42,7.38,90
1783910013,RCS752,40,41,7.38,81
1783910013,RCS753,86,0,7.38,86
1783910013,RCS754,177,0,7.38,177
1783910014,RAS101,19,28,6.25,47
1783910014,REC101,24,29,6.25,53
1783910014,RAS103,18,35,6.25,53
1783910014,REE101,15,29,6.25,44
1783910014,RAS104,23,46,6.25,69
1783910014,RAS151,39,41,6.25,80
1783910014,REE151,42,42,6.25,84
1783910014,RAS154,42,45,6.25,87
1783910014,RME152,42,44,6.25,86
1783910014,RAS203,16,28,6.0,44
1783910014,RAS201,15,32,6.0,47
1783910014,RME201,21,41,6.0,62
1783910014,RCS201,19,26,6.0,45
1783910014,RAS202,24,32,6.0,56
1783910014,RAS252,40,43,6.0,83
1783910014,RME251,37,36,6.0,73
1783910014,RCS251,38,39,6.0,77
1783910014,RCE251,38,37,6.0,75
1783910014,ROE037,20,45,7.04,65
1783910014,RAS302,17,55,7.04,72
1783910014,REC301,21,25,7.04,46
1783910014,RCS301,22,45,7.04,67
1783910014,RCS302,22,38,7.04,60
1783910014,RCS305,22,37,7.04,59
1783910014,REC351,47,37,7.04,84
1783910014,RCS351,45,46,7.04,91
1783910014,RCS352,38,37,7.04,75
1783910014,RCS355,41,48,7.04,89
1783910014,RAS401,16,28,6.33,44
1783910014,RVE401,29,37,6.33,66
1783910014,REC405,17,25,6.33,42
1783910014,RCS401,17,44,6.33,61
1783910014,RCS402,21,51,6.33,72
1783910014,RCS403,15,39,6.33,54
1783910014,RCS451,37,43,6.33,80
1783910014,RCS452,38,41,6.33,79
1783910014,RCS453,40,43,6.33,83
1783910014,RCS454,39,39,6.33,78
1783910014,RAS501,26,37,6.71,63
1783910014,RUC501,23,47,6.71,70
1783910014,RCS501,23,46,6.71,69
1783910014,RCS502,12,32,6.71,44
1783910014,RCS503,23,32,6.71,55
1783910014,RCS052,23,38,6.71,61
1783910014,RCS551,43,43,6.71,86
1783910014,RCS552,30,33,6.71,63
1783910014,RCS553,44,45,6.71,89
1783910014,RCS554,35,38,6.71,73
1783910014,RAS601,27,45,7.88,72
1783910014,RAS602,28,46,7.88,74
1783910014,RCS601,22,41,7.88,63
1783910014,RCS602,27,45,7.88,72
1783910014,RCS603,26,44,7.88,70
1783910014,RCS061,21,41,7.88,62
1783910014,RCS651,39,41,7.88,80
1783910014,RCS652,46,43,7.88,89
1783910014,RCS653,39,41,7.88,80
1783910014,RCS654,45,43,7.88,88
1783910014,ROE072,26,46,7.96,72
1783910014,RCS071,22,37,7.96,59
1783910014,RCS078,27,45,7.96,72
1783910014,RCS701,26,49,7.96,75
1783910014,RCS702,27,46,7.96,73
1783910014,RCS751,47,40,7.96,87
1783910014,RCS752,45,43,7.96,88
1783910014,RCS753,74,0,7.96,74
1783910014,RCS754,167,0,7.96,167
1783910015,RAS101,18,35,7.54,53
1783910015,REC101,20,40,7.54,60
1783910015,RAS103,24,48,7.54,72
1783910015,REE101,18,52,7.54,70
1783910015,RAS104,23,44,7.54,67
1783910015,RAS151,36,38,7.54,74
1783910015,REE151,43,42,7.54,85
1783910015,RAS154,43,46,7.54,89
1783910015,RME152,45,44,7.54,89
1783910015,RAS203,15,49,6.25,64
1783910015,RAS201,19,29,6.25,48
1783910015,RME201,23,39,6.25,62
1783910015,RCS201,20,28,6.25,48
1783910015,RAS202,16,31,6.25,47
1783910015,RAS252,35,41,6.25,76
1783910015,RME251,39,32,6.25,71
1783910015,RCS251,41,42,6.25,83
1783910015,RCE251,30,30,6.25,60
1783910015,ROE037,22,35,6.96,57
1783910015,RAS302,20,27,6.96,47
1783910015,REC301,21,38,6.96,59
1783910015,RCS301,20,62,6.96,82
1783910015,RCS302,16,41,6.96,57
1783910015,RCS305,19,48,6.96,67
1783910015,REC351,43,43,6.96,86
1783910015,RCS351,44,46,6.96,90
1783910015,RCS352,36,38,6.96,74
1783910015,RCS355,43,48,6.96,91
1783910015,RAS401,8,46,6.5,54
1783910015,RVE401,27,33,6.5,60
1783910015,REC405,14,31,6.5,45
1783910015,RCS401,18,34,6.5,52
1783910015,RCS402,14,39,6.5,53
1783910015,RCS403,17,37,6.5,54
1783910015,RCS451,38,44,6.5,82
1783910015,RCS452,41,46,6.5,87
1783910015,RCS453,40,42,6.5,82
1783910015,RCS454,43,40,6.5,83
1783910015,RAS501,26,40,6.67,66
1783910015,RUC501,12,41,6.67,53
1783910015,RCS501,22,44,6.67,66
1783910015,RCS502,7,50,6.67,57
1783910015,RCS503,19,32,6.67,51
1783910015,RCS052,20,40,6.67,60
1783910015,RCS551,39,40,6.67,79
1783910015,RCS552,30,30,6.67,60
1783910015,RCS553,39,40,6.67,79
1783910015,RCS554,31,30,6.67,61
1783910015,RAS601,27,47,7.83,74
1783910015,RAS602,28,48,7.83,76
1783910015,RCS601,23,44,7.83,67
1783910015,RCS602,27,47,7.83,74
1783910015,RCS603,26,46,7.83,72
1783910015,RCS061,19,41,7.83,60
1783910015,RCS651,38,40,7.83,78
1783910015,RCS652,46,43,7.83,89
1783910015,RCS653,40,41,7.83,81
1783910015,RCS654,45,43,7.83,88
1783910017,RAS101,28,50,8.17,78
1783910017,REC101,20,48,8.17,68
1783910017,RAS103,28,67,8.17,95
1783910017,REE101,19,60,8.17,79
1783910017,RAS104,19,35,8.17,54
1783910017,RAS151,48,48,8.17,96
1783910017,REE151,44,40,8.17,84
1783910017,RAS154,44,38,8.17,82
1783910017,RME152,45,43,8.17,88
1783910017,RAS203,30,56,7.17,86
1783910017,RAS201,21,28,7.17,49
1783910017,RME201,24,43,7.17,67
1783910017,RCS201,23,32,7.17,55
1783910017,RAS202,28,30,7.17,58
1783910017,RAS252,46,48,7.17,94
1783910017,RME251,43,40,7.17,83
1783910017,RCS251,45,41,7.17,86
1783910017,RCE251,42,42,7.17,84
1783910017,ROE037,22,39,7.29,61
1783910017,RAS302,17,45,7.29,62
1783910017,REC301,30,25,7.29,55
1783910017,RCS301,21,49,7.29,70
1783910017,RCS302,25,25,7.29,50
1783910017,RCS305,24,38,7.29,62
1783910017,REC351,46,49,7.29,95
1783910017,RCS351,42,47,7.29,89
1783910017,RCS352,45,44,7.29,89
1783910017,RCS355,44,48,7.29,92
1783910017,RAS401,27,45,7.75,72
1783910017,RVE401,27,36,7.75,63
1783910017,REC405,26,48,7.75,74
1783910017,RCS401,24,47,7.75,71
1783910017,RCS402,20,39,7.75,59
1783910017,RCS403,23,39,7.75,62
1783910017,RCS451,44,40,7.75,84
1783910017,RCS452,45,46,7.75,91
1783910017,RCS453,48,49,7.75,97
1783910017,RCS454,46,45,7.75,91
1783910017,RAS501,25,28,6.38,53
1783910017,RUC501,23,34,6.38,57
1783910017,RCS501,24,41,6.38,65
1783910017,RCS502,8,32,6.38,40
1783910017,RCS503,25,32,6.38,57
1783910017,RCS052,25,41,6.38,66
1783910017,RCS551,44,44,6.38,88
1783910017,RCS552,30,33,6.38,63
1783910017,RCS553,46,46,6.38,92
1783910017,RCS554,40,39,6.38,79
1783910017,RAS601,28,49,7.42,77
1783910017,RAS602,28,49,7.42,77
1783910017,RCS601,21,44,7.42,65
1783910017,RCS602,22,44,7.42,66
1783910017,RCS603,22,44,7.42,66
1783910017,RCS061,15,40,7.42,55
1783910017,RCS651,43,44,7.42,87
1783910017,RCS652,42,44,7.42,86
1783910017,RCS653,38,42,7.42,80
1783910017,RCS654,42,44,7.42,86
1783910017,ROE072,24,33,7.38,57
1783910017,RCS071,22,38,7.38,60
1783910017,RCS078,27,32,7.38,59
1783910017,RCS701,26,45,7.38,71
1783910017,RCS702,25,22,7.38,47
1783910017,RCS751,47,48,7.38,95
1783910017,RCS752,42,48,7.38,90
1783910017,RCS753,90,0,7.38,90
1783910017,RCS754,167,0,7.38,167
1783910018,RAS101,25,60,8.25,85
1783910018,REC101,28,58,8.25,86
1783910018,RAS103,28,53,8.25,81
1783910018,REE101,20,34,8.25,54
1783910018,RAS104,25,34,8.25,59
1783910018,RAS151,40,42,8.25,82
1783910018,REE151,46,41,8.25,87
1783910018,RAS154,46,46,8.25,92
1783910018,RME152,47,46,8.25,93
1783910018,RAS203,27,56,8.42,83
1783910018,RAS201,25,46,8.42,71
1783910018,RME201,28,35,8.42,63
1783910018,RCS201,28,44,8.42,72
1783910018,RAS202,29,48,8.42,77
1783910018,RAS252,46,47,8.42,93
1783910018,RME251,49,42,8.42,91
1783910018,RCS251,49,43,8.42,92
1783910018,RCE251,48,46,8.42,94
1783910018,ROE037,28,48,7.67,76
1783910018,RAS302,26,37,7.67,63
1783910018,REC301,30,39,7.67,69
1783910018,RCS301,22,54,7.67,76
1783910018,RCS302,29,30,7.67,59
1783910018,RCS305,26,39,7.67,65
1783910018,REC351,47,49,7.67,96
1783910018,RCS351,45,49,7.67,94
1783910018,RCS352,48,49,7.67,97
1783910018,RCS355,47,48,7.67,95
1783910018,RAS401,29,58,8.5,87
1783910018,RVE401,29,45,8.5,74
1783910018,REC405,30,49,8.5,79
1783910018,RCS401,30,49,8.5,79
1783910018,RCS402,20,41,8.5,61
1783910018,RCS403,25,58,8.5,83
1783910018,RCS451,50,48,8.5,98
1783910018,RCS452,49,45,8.5,94
1783910018,RCS453,41,41,8.5,82
1783910018,RCS454,49,49,8.5,98
1783910018,RAS501,26,45,7.83,71
1783910018,RUC501,24,50,7.83,74
1783910018,RCS501,28,55,7.83,83
1783910018,RCS502,22,29,7.83,51
1783910018,RCS503,30,37,7.83,67
1783910018,RCS052,28,39,7.83,67
1783910018,RCS551,48,49,7.83,97
1783910018,RCS552,47,48,7.83,95
1783910018,RCS553,50,49,7.83,99
1783910018,RCS554,48,46,7.83,94
1783910018,RAS601,27,51,8.71,78
1783910018,RAS602,28,52,8.71,80
1783910018,RCS601,24,49,8.71,73
1783910018,RCS602,30,53,8.71,83
1783910018,RCS603,29,52,8.71,81
1783910018,RCS061,23,48,8.71,71
1783910018,RCS651,38,44,8.71,82
1783910018,RCS652,49,48,8.71,97
1783910018,RCS653,49,48,8.71,97
1783910018,RCS654,49,48,8.71,97
1783910018,ROE072,23,33,7.92,56
1783910018,RCS071,26,34,7.92,60
1783910018,RCS078,28,40,7.92,68
1783910018,RCS701,29,47,7.92,76
1783910018,RCS702,28,38,7.92,66
1783910018,RCS751,49,49,7.92,98
1783910018,RCS752,47,48,7.92,95
1783910018,RCS753,90,0,7.92,90
1783910018,RCS754,180,0,7.92,180
1783910019,RAS101,20,53,8.29,73
1783910019,REC101,27,50,8.29,77
1783910019,RAS103,27,66,8.29,93
1783910019,REE101,20,46,8.29,66
1783910019,RAS104,24,45,8.29,69
1783910019,RAS151,38,40,8.29,78
1783910019,REE151,47,42,8.29,89
1783910019,RAS154,47,42,8.29,89
1783910019,RME152,47,46,8.29,93
1783910019,RAS203,28,49,8.5,77
1783910019,RAS201,29,51,8.5,80
1783910019,RME201,27,56,8.5,83
1783910019,RCS201,25,42,8.5,67
1783910019,RAS202,28,50,8.5,78
1783910019,RAS252,44,45,8.5,89
1783910019,RME251,49,40,8.5,89
1783910019,RCS251,45,38,8.5,83
1783910019,RCE251,48,46,8.5,94
1783910019,ROE037,23,52,8.29,75
1783910019,RAS302,16,52,8.29,68
1783910019,REC301,28,47,8.29,75
1783910019,RCS301,24,65,8.29,89
1783910019,RCS302,29,37,8.29,66
1783910019,RCS305,22,61,8.29,83
1783910019,REC351,41,45,8.29,86
1783910019,RCS351,44,49,8.29,93
1783910019,RCS352,44,45,8.29,89
1783910019,RCS355,46,48,8.29,94
1783910019,RAS401,30,49,7.92,79
1783910019,RVE401,28,50,7.92,78
1783910019,REC405,26,50,7.92,76
1783910019,RCS401,30,46,7.92,76
1783910019,RCS402,20,28,7.92,48
1783910019,RCS403,25,48,7.92,73
1783910019,RCS451,50,46,7.92,96
1783910019,RCS452,49,48,7.92,97
1783910019,RCS453,41,42,7.92,83
1783910019,RCS454,49,49,7.92,98
1783910019,RAS501,29,52,8.17,81
1783910019,RUC501,23,55,8.17,78
1783910019,RCS501,27,50,8.17,77
1783910019,RCS502,19,45,8.17,64
1783910019,RCS503,26,33,8.17,59
1783910019,RCS052,29,58,8.17,87
1783910019,RCS551,47,47,8.17,94
1783910019,RCS552,40,45,8.17,85
1783910019,RCS553,48,48,8.17,96
1783910019,RCS554,49,47,8.17,96
1783910019,RAS601,29,55,8.79,84
1783910019,RAS602,29,55,8.79,84
1783910019,RCS601,22,50,8.79,72
1783910019,RCS602,29,55,8.79,84
1783910019,RCS603,27,54,8.79,81
1783910019,RCS061,22,50,8.79,72
1783910019,RCS651,37,43,8.79,80
1783910019,RCS652,48,46,8.79,94
1783910019,RCS653,46,46,8.79,92
1783910019,RCS654,44,45,8.79,89
1783910019,ROE072,27,48,8.54,75
1783910019,RCS071,25,39,8.54,64
1783910019,RCS078,28,47,8.54,75
1783910019,RCS701,26,55,8.54,81
1783910019,RCS702,28,47,8.54,75
1783910019,RCS751,47,40,8.54,87
1783910019,RCS752,47,41,8.54,88
1783910019,RCS753,90,0,8.54,90
1783910019,RCS754,180,0,8.54,180
1783910020,RAS101,19,46,7.17,65
1783910020,REC101,27,46,7.17,73
1783910020,RAS103,25,35,7.17,60
1783910020,REE101,15,29,7.17,44
1783910020,RAS104,26,37,7.17,63
1783910020,RAS151,39,41,7.17,80
1783910020,REE151,42,38,7.17,80
1783910020,RAS154,42,46,7.17,88
1783910020,RME152,46,44,7.17,90
1783910020,RAS203,20,49,7.04,69
1783910020,RAS201,25,23,7.04,48
1783910020,RME201,22,23,7.04,45
1783910020,RCS201,27,44,7.04,71
1783910020,RAS202,28,39,7.04,67
1783910020,RAS252,44,46,7.04,90
1783910020,RME251,45,37,7.04,82
1783910020,RCS251,47,43,7.04,90
1783910020,RCE251,45,45,7.04,90
1783910020,ROE037,19,43,7.46,62
1783910020,RAS302,19,33,7.46,52
1783910020,REC301,22,41,7.46,63
1783910020,RCS301,22,49,7.46,71
1783910020,RCS302,21,39,7.46,60
1783910020,RCS305,20,42,7.46,62
1783910020,REC351,46,44,7.46,90
1783910020,RCS351,47,47,7.46,94
1783910020,RCS352,40,41,7.46,81
1783910020,RCS355,47,47,7.46,94
1783910020,RAS401,26,43,7.08,69
1783910020,RVE401,30,48,7.08,78
1783910020,REC405,20,30,7.08,50
1783910020,RCS401,26,42,7.08,68
1783910020,RCS402,17,40,7.08,57
1783910020,RCS403,20,37,7.08,57
1783910020,RCS451,46,42,7.08,88
1783910020,RCS452,44,47,7.08,91
1783910020,RCS453,40,40,7.08,80
1783910020,RCS454,44,40,7.08,84
1783910020,RAS501,30,44,7.71,74
1783910020,RUC501,23,49,7.71,72
1783910020,RCS501,26,43,7.71,69
1783910020,RCS502,18,50,7.71,68
1783910020,RCS503,30,27,7.71,57
1783910020,RCS052,27,52,7.71,79
1783910020,RCS551,46,46,7.71,92
1783910020,RCS552,42,42,7.71,84
1783910020,RCS553,49,49,7.71,98
1783910020,RCS554,44,45,7.71,89
1783910020,RAS601,29,49,8.0,78
1783910020,RAS602,29,49,8.0,78
1783910020,RCS601,23,45,8.0,68
1783910020,RCS602,29,49,8.0,78
1783910020,RCS603,28,49,8.0,77
1783910020,RCS061,21,44,8.0,65
1783910020,RCS651,41,43,8.0,84
1783910020,RCS652,48,45,8.0,93
1783910020,RCS653,47,45,8.0,92
1783910020,RCS654,45,45,8.0,90
1783910020,ROE072,25,33,7.17,58
1783910020,RCS071,25,27,7.17,52
1783910020,RCS078,28,37,7.17,65
1783910020,RCS701,26,30,7.17,56
1783910020,RCS702,26,40,7.17,66
1783910020,RCS751,47,42,7.17,89
1783910020,RCS752,43,44,7.17,87
1783910020,RCS753,86,0,7.17,86
1783910020,RCS754,178,0,7.17,178
1783910021,RAS101,15,41,6.46,56
1783910021,REC101,19,31,6.46,50
1783910021,RAS103,19,30,6.46,49
1783910021,REE101,27,23,6.46,50
1783910021,RAS104,19,32,6.46,51
1783910021,RAS151,40,42,6.46,82
1783910021,REE151,42,38,6.46,80
1783910021,RAS154,42,44,6.46,86
1783910021,RME152,44,43,6.46,87
1783910021,RAS203,19,33,5.58,52
1783910021,RAS201,15,31,5.58,46
1783910021,RME201,20,24,5.58,44
1783910021,RCS201,19,50,5.58,69
1783910021,RAS202,15,25,5.58,40
1783910021,RAS252,32,38,5.58,70
1783910021,RME251,30,31,5.58,61
1783910021,RCS251,37,38,5.58,75
1783910021,RCE251,31,32,5.58,63
1783910021,ROE037,19,36,6.04,55
1783910021,RAS302,14,27,6.04,41
1783910021,REC301,18,33,6.04,51
1783910021,RCS301,16,31,6.04,47
1783910021,RCS302,15,32,6.04,47
1783910021,RCS305,20,32,6.04,52
1783910021,REC351,44,44,6.04,88
1783910021,RCS351,45,46,6.04,91
1783910021,RCS352,36,37,6.04,73
1783910021,RCS355,45,47,6.04,92
1783910021,RAS401,12,30,5.08,42
1783910021,RVE401,27,23,5.08,50
1783910021,REC405,14,29,5.08,43
1783910021,RCS401,14,29,5.08,43
1783910021,RCS402,14,27,5.08,41
1783910021,RCS403,18,26,5.08,44
1783910021,RCS451,34,41,5.08,75
1783910021,RCS452,34,47,5.08,81
1783910021,RCS453,47,48,5.08,95
1783910021,RCS454,44,36,5.08,80
1783910021,RAS501,23,31,5.33,54
1783910021,RUC501,22,26,5.33,48
1783910021,RCS501,22,38,5.33,60
1783910021,RCS502,13,26,5.33,39
1783910021,RCS503,25,23,5.33,48
1783910021,RCS052,25,32,5.33,57
1783910021,RCS551,42,42,5.33,84
1783910021,RCS552,34,37,5.33,71
1783910021,RCS553,47,47,5.33,94
1783910021,RCS554,42,33,5.33,75
1783910021,RAS601,28,42,7.29,70
1783910021,RAS602,28,42,7.29,70
1783910021,RCS601,21,37,7.29,58
1783910021,RCS602,27,41,7.29,68
1783910021,RCS603,25,40,7.29,65
1783910021,RCS061,17,34,7.29,51
1783910021,RCS651,41,41,7.29,82
1783910021,RCS652,46,43,7.29,89
1783910021,RCS653,45,43,7.29,88
1783910021,RCS654,45,43,7.29,88
1783910021,ROE072,27,31,7.38,58
1783910021,RCS071,23,31,7.38,54
1783910021,RCS078,26,38,7.38,64
1783910021,RCS701,26,42,7.38,68
1783910021,RCS702,26,43,7.38,69
1783910021,RCS751,47,41,7.38,88
1783910021,RCS752,43,47,7.38,90
1783910021,RCS753,80,0,7.38,80
1783910021,RCS754,170,0,7.38,170
1783910023,RAS101,15,47,5.92,62
1783910023,REC101,18,30,5.92,48
1783910023,RAS103,16,26,5.92,42
1783910023,REE101,15,25,5.92,40
1783910023,RAS104,18,35,5.92,53
1783910023,RAS151,36,39,5.92,75
1783910023,REE151,42,40,5.92,82
1783910023,RAS154,42,45,5.92,87
1783910023,RME152,41,43,5.92,84
1783910023,RAS203,13,21,3.0,34
1783910023,RAS201,15,23,3.0,38
1783910023,RME201,15,27,3.0,42
1783910023,RCS201,19,31,3.0,50
1783910023,RAS202,15,21,3.0,36
1783910023,RAS252,38,41,3.0,79
1783910023,RME251,36,34,3.0,70
1783910023,RCS251,38,40,3.0,78
1783910023,RCE251,30,30,3.0,60
1783910023,ROE037,18,33,3.92,51
1783910023,RAS302,15,38,3.92,53
1783910023,REC301,12,16,3.92,28
1783910023,RCS301,12,21,3.92,33
1783910023,RCS302,14,21,3.92,35
1783910023,RCS305,15,26,3.92,41
1783910023,REC351,41,36,3.92,77
1783910023,RCS351,45,46,3.92,91
1783910023,RCS352,34,38,3.92,72
1783910023,RCS355,43,48,3.92,91
1783910023,RAS401,5,21,2.0,26
1783910023,RVE401,23,35,2.0,58
1783910023,REC405,14,16,2.0,30
1783910023,RCS401,12,26,2.0,38
1783910023,RCS402,2,30,2.0,32
1783910023,RCS403,7,3,2.0,10
1783910023,RCS451,32,39,2.0,71
1783910023,RCS452,35,33,2.0,68
1783910023,RCS453,30,34,2.0,64
1783910023,RCS454,35,38,2.0,73
1783910023,KAS302,30,16,3.59,46
1783910023,KAS301,38,51,3.59,89
1783910023,KCS301,16,31,3.59,47
1783910023,KCS302,26,43,3.59,69
1783910023,KCS303,30,32,3.59,62
1783910023,KCS351,18,17,3.59,35
1783910023,KCS352,17,17,3.59,34
1783910023,KCS353,17,17,3.59,34
1783910023,KCS354,30,0,3.59,30
1783910023,KNC301,0,0,3.59,0
1783910023,KOE048,39,50,6.48,89
1783910023,KVE401,31,46,6.48,77
1783910023,KCS401,31,46,6.48,77
1783910023,KCS402,31,46,6.48,77
1783910023,KCS403,31,46,6.48,77
1783910023,KCS451,17,25,6.48,42
1783910023,KCS452,17,25,6.48,42
1783910023,KCS453,20,25,6.48,45
1783910023,KCS501,39,57,6.55,96
1783910023,KCS502,43,33,6.55,76
1783910023,KCS503,39,35,6.55,74
1783910023,KCS053,40,44,6.55,84
1783910023,KCS056,38,54,6.55,92
1783910023,KCS551,20,18,6.55,38
1783910023,KCS552,20,21,6.55,41
1783910023,KCS553,18,20,6.55,38
1783910023,KCS554,38,0,6.55,38
1783910023,KNC502,23,0,6.55,23
1783910024,RAS101,19,44,7.79,63
1783910024,REC101,28,42,7.79,70
1783910024,RAS103,22,59,7.79,81
1783910024,REE101,21,42,7.79,63
1783910024,RAS104,19,40,7.79,59
1783910024,RAS151,43,44,7.79,87
1783910024,REE151,44,42,7.79,86
1783910024,RAS154,44,40,7.79,84
1783910024,RME152,47,42,7.79,89
1783910024,RAS203,25,45,7.92,70
1783910024,RAS201,22,40,7.92,62
1783910024,RME201,22,46,7.92,68
1783910024,RCS201,26,42,7.92,68
1783910024,RAS202,28,50,7.92,78
1783910024,RAS252,47,48,7.92,95
1783910024,RME251,46,45,7.92,91
1783910024,RCS251,46,38,7.92,84
1783910024,RCE251,48,46,7.92,94
1783910024,ROE037,24,42,7.13,66
1783910024,RAS302,22,27,7.13,49
1783910024,REC301,29,36,7.13,65
1783910024,RCS301,27,47,7.13,74
1783910024,RCS302,22,25,7.13,47
1783910024,RCS305,25,42,7.13,67
1783910024,REC351,48,48,7.13,96
1783910024,RCS351,45,47,7.13,92
1783910024,RCS352,46,47,7.13,93
1783910024,RCS355,45,47,7.13,92
1783910024,RAS401,28,53,7.79,81
1783910024,RVE401,27,43,7.79,70
1783910024,REC405,30,45,7.79,75
1783910024,RCS401,25,37,7.79,62
1783910024,RCS402,20,25,7.79,45
1783910024,RCS403,21,44,7.79,65
1783910024,RCS451,45,40,7.79,85
1783910024,RCS452,45,46,7.79,91
1783910024,RCS453,47,47,7.79,94
1783910024,RCS454,45,46,7.79,91
1783910024,RAS501,28,49,6.96,77
1783910024,RUC501,20,48,6.96,68
1783910024,RCS501,25,40,6.96,65
1783910024,RCS502,18,26,6.96,44
1783910024,RCS503,27,31,6.96,58
1783910024,RCS052,29,36,6.96,65
1783910024,RCS551,45,45,6.96,90
1783910024,RCS552,38,43,6.96,81
1783910024,RCS553,48,48,6.96,96
1783910024,RCS554,48,46,6.96,94
1783910024,RAS601,29,49,8.08,78
1783910024,RAS602,30,50,8.08,80
1783910024,RCS601,18,42,8.08,60
1783910024,RCS602,28,49,8.08,77
1783910024,RCS603,25,47,8.08,72
1783910024,RCS061,19,42,8.08,61
1783910024,RCS651,38,43,8.08,81
1783910024,RCS652,47,46,8.08,93
1783910024,RCS653,44,45,8.08,89
1783910024,RCS654,45,46,8.08,91
1783910024,ROE072,29,42,7.71,71
1783910024,RCS071,27,47,7.71,74
1783910024,RCS078,26,41,7.71,67
1783910024,RCS701,24,45,7.71,69
1783910024,RCS702,28,31,7.71,59
1783910024,RCS751,45,44,7.71,89
1783910024,RCS752,47,40,7.71,87
1783910024,RCS753,81,0,7.71,81
1783910024,RCS754,169,0,7.71,169
1783910025,RAS101,21,51,8.17,72
1783910025,REC101,24,42,8.17,66
1783910025,RAS103,25,53,8.17,78
1783910025,REE101,22,53,8.17,75
1783910025,RAS104,25,54,8.17,79
1783910025,RAS151,42,44,8.17,86
1783910025,REE151,45,40,8.17,85
1783910025,RAS154,45,45,8.17,90
1783910025,RME152,46,44,8.17,90
1783910025,RAS203,27,56,8.71,83
1783910025,RAS201,28,48,8.71,76
1783910025,RME201,24,46,8.71,70
1783910025,RCS201,29,51,8.71,80
1783910025,RAS202,28,50,8.71,78
1783910025,RAS252,48,48,8.71,96
1783910025,RME251,46,46,8.71,92
1783910025,RCS251,48,44,8.71,92
1783910025,RCE251,46,45,8.71,91
1783910025,ROE037,22,46,7.79,68
1783910025,RAS302,23,36,7.79,59
1783910025,REC301,29,53,7.79,82
1783910025,RCS301,25,53,7.79,78
1783910025,RCS302,23,30,7.79,53
1783910025,RCS305,26,53,7.79,79
1783910025,REC351,48,48,7.79,96
1783910025,RCS351,48,47,7.79,95
1783910025,RCS352,44,48,7.79,92
1783910025,RCS355,49,49,7.79,98
1783910025,RAS401,29,47,7.88,76
1783910025,RVE401,30,40,7.88,70
1783910025,REC405,17,58,7.88,75
1783910025,RCS401,18,43,7.88,61
1783910025,RCS402,25,47,7.88,72
1783910025,RCS403,24,41,7.88,65
1783910025,RCS451,38,43,7.88,81
1783910025,RCS452,37,49,7.88,86
1783910025,RCS453,45,46,7.88,91
1783910025,RCS454,38,37,7.88,75
1783910025,RAS501,28,49,8.29,77
1783910025,RUC501,24,50,8.29,74
1783910025,RCS501,27,54,8.29,81
1783910025,RCS502,25,50,8.29,75
1783910025,RCS503,30,45,8.29,75
1783910025,RCS052,29,38,8.29,67
1783910025,RCS551,48,48,8.29,96
1783910025,RCS552,49,48,8.29,97
1783910025,RCS553,49,49,8.29,98
1783910025,RCS554,48,49,8.29,97
1783910025,RAS601,28,54,8.83,82
1783910025,RAS602,28,54,8.83,82
1783910025,RCS601,24,51,8.83,75
1783910025,RCS602,30,55,8.83,85
1783910025,RCS603,27,53,8.83,80
1783910025,RCS061,25,52,8.83,77
1783910025,RCS651,41,44,8.83,85
1783910025,RCS652,48,46,8.83,94
1783910025,RCS653,46,46,8.83,92
1783910025,RCS654,49,47,8.83,96
1783910025,ROE072,27,39,8.38,66
1783910025,RCS071,24,49,8.38,73
1783910025,RCS078,27,47,8.38,74
1783910025,RCS701,27,44,8.38,71
1783910025,RCS702,28,55,8.38,83
1783910025,RCS751,48,47,8.38,95
1783910025,RCS752,47,45,8.38,92
1783910025,RCS753,88,0,8.38,88
1783910025,RCS754,171,0,8.38,171
1783910026,RAS101,18,30,6.42,48
1783910026,REC101,23,21,6.42,44
1783910026,RAS103,21,48,6.42,69
1783910026,REE101,16,42,6.42,58
1783910026,RAS104,23,42,6.42,65
1783910026,RAS151,40,42,6.42,82
1783910026,REE151,42,40,6.42,82
1783910026,RAS154,42,38,6.42,80
1783910026,RME152,44,43,6.42,87
1783910026,RAS203,14,32,6.13,46
1783910026,RAS201,15,39,6.13,54
1783910026,RME201,20,44,6.13,64
1783910026,RCS201,19,21,6.13,40
1783910026,RAS202,15,39,6.13,54
1783910026,RAS252,32,36,6.13,68
1783910026,RME251,30,40,6.13,70
1783910026,RCS251,37,39,6.13,76
1783910026,RCE251,38,36,6.13,74
1783910026,ROE037,19,37,6.29,56
1783910026,RAS302,17,33,6.29,50
1783910026,REC301,19,33,6.29,52
1783910026,RCS301,15,34,6.29,49
1783910026,RCS302,25,21,6.29,46
1783910026,RCS305,21,32,6.29,53
1783910026,REC351,47,36,6.29,83
1783910026,RCS351,43,45,6.29,88
1783910026,RCS352,39,42,6.29,81
1783910026,RCS355,45,47,6.29,92
1783910026,RAS401,14,37,6.46,51
1783910026,RVE401,23,30,6.46,53
1783910026,REC405,18,39,6.46,57
1783910026,RCS401,18,42,6.46,60
1783910026,RCS402,17,32,6.46,49
1783910026,RCS403,19,39,6.46,58
1783910026,RCS451,38,41,6.46,79
1783910026,RCS452,39,41,6.46,80
1783910026,RCS453,40,43,6.46,83
1783910026,RCS454,38,48,6.46,86
1783910026,RAS501,23,39,5.54,62
1783910026,RUC501,19,28,5.54,47
1783910026,RCS501,22,36,5.54,58
1783910026,RCS502,9,26,5.54,35
1783910026,RCS503,23,40,5.54,63
1783910026,RCS052,25,30,5.54,55
1783910026,RCS551,42,42,5.54,84
1783910026,RCS552,30,33,5.54,63
1783910026,RCS553,46,46,5.54,92
1783910026,RCS554,40,36,5.54,76
1783910026,RAS601,26,43,7.46,69
1783910026,RAS602,27,44,7.46,71
1783910026,RCS601,21,40,7.46,61
1783910026,RCS602,26,43,7.46,69
1783910026,RCS603,24,42,7.46,66
1783910026,RCS061,23,41,7.46,64
1783910026,RCS651,40,41,7.46,81
1783910026,RCS652,44,42,7.46,86
1783910026,RCS653,42,42,7.46,84
1783910026,RCS654,44,42,7.46,86
1783910026,ROE072,23,30,7.63,53
1783910026,RCS071,23,43,7.63,66
1783910026,RCS078,26,35,7.63,61
1783910026,RCS701,25,54,7.63,79
1783910026,RCS702,24,40,7.63,64
1783910026,RCS751,46,40,7.63,86
1783910026,RCS752,40,47,7.63,87
1783910026,RCS753,82,0,7.63,82
1783910026,RCS754,169,0,7.63,169
1783910027,RAS101,23,50,7.75,73
1783910027,REC101,23,54,7.75,77
1783910027,RAS103,21,48,7.75,69
1783910027,REE101,18,53,7.75,71
1783910027,RAS104,19,36,7.75,55
1783910027,RAS151,39,41,7.75,80
1783910027,REE151,43,31,7.75,74
1783910027,RAS154,43,46,7.75,89
1783910027,RME152,42,42,7.75,84
1783910027,RAS203,19,26,7.54,45
1783910027,RAS201,28,46,7.54,74
1783910027,RME201,26,55,7.54,81
1783910027,RCS201,24,30,7.54,54
1783910027,RAS202,28,45,7.54,73
1783910027,RAS252,48,48,7.54,96
1783910027,RME251,36,34,7.54,70
1783910027,RCS251,46,43,7.54,89
1783910027,RCE251,39,40,7.54,79
1783910027,ROE037,22,42,6.71,64
1783910027,RAS302,18,28,6.71,46
1783910027,REC301,18,27,6.71,45
1783910027,RCS301,20,49,6.71,69
1783910027,RCS302,26,35,6.71,61
1783910027,RCS305,23,31,6.71,54
1783910027,REC351,44,45,6.71,89
1783910027,RCS351,46,45,6.71,91
1783910027,RCS352,39,42,6.71,81
1783910027,RCS355,43,45,6.71,88
1783910027,RAS401,22,39,6.5,61
1783910027,RVE401,29,42,6.5,71
1783910027,REC405,18,37,6.5,55
1783910027,RCS401,19,42,6.5,61
1783910027,RCS402,16,32,6.5,48
1783910027,RCS403,20,22,6.5,42
1783910027,RCS451,39,40,6.5,79
1783910027,RCS452,40,42,6.5,82
1783910027,RCS453,40,43,6.5,83
1783910027,RCS454,38,35,6.5,73
1783910027,RAS501,24,43,7.42,67
1783910027,RUC501,21,42,7.42,63
1783910027,RCS501,22,49,7.42,71
1783910027,RCS502,13,44,7.42,57
1783910027,RCS503,25,44,7.42,69
1783910027,RCS052,25,45,7.42,70
1783910027,RCS551,42,42,7.42,84
1783910027,RCS552,33,37,7.42,70
1783910027,RCS553,47,47,7.42,94
1783910027,RCS554,40,37,7.42,77
1783910027,RAS601,28,49,7.88,77
1783910027,RAS602,28,49,7.88,77
1783910027,RCS601,22,44,7.88,66
1783910027,RCS602,28,49,7.88,77
1783910027,RCS603,26,47,7.88,73
1783910027,RCS061,20,43,7.88,63
1783910027,RCS651,41,41,7.88,82
1783910027,RCS652,46,43,7.88,89
1783910027,RCS653,45,43,7.88,88
1783910027,RCS654,45,43,7.88,88
1783910027,ROE072,27,27,7.75,54
1783910027,RCS071,27,54,7.75,81
1783910027,RCS078,24,41,7.75,65
1783910027,RCS701,25,49,7.75,74
1783910027,RCS702,24,31,7.75,55
1783910027,RCS751,46,41,7.75,87
1783910027,RCS752,40,44,7.75,84
1783910027,RCS753,80,0,7.75,80
1783910027,RCS754,166,0,7.75,166
1783910028,RAS101,24,48,8.04,72
1783910028,REC101,27,35,8.04,62
1783910028,RAS103,29,68,8.04,97
1783910028,REE101,20,44,8.04,64
1783910028,RAS104,21,38,8.04,59
1783910028,RAS151,40,42,8.04,82
1783910028,REE151,44,42,8.04,86
1783910028,RAS154,44,43,8.04,87
1783910028,RME152,46,46,8.04,92
1783910028,RAS203,29,49,8.17,78
1783910028,RAS201,22,45,8.17,67
1783910028,RME201,29,51,8.17,80
1783910028,RCS201,23,50,8.17,73
1783910028,RAS202,28,41,8.17,69
1783910028,RAS252,48,48,8.17,96
1783910028,RME251,43,40,8.17,83
1783910028,RCS251,44,45,8.17,89
1783910028,RCE251,48,46,8.17,94
1783910028,ROE037,21,40,7.88,61
1783910028,RAS302,18,35,7.88,53
1783910028,REC301,29,43,7.88,72
1783910028,RCS301,28,60,7.88,88
1783910028,RCS302,28,35,7.88,63
1783910028,RCS305,24,52,7.88,76
1783910028,REC351,44,48,7.88,92
1783910028,RCS351,46,49,7.88,95
1783910028,RCS352,43,44,7.88,87
1783910028,RCS355,46,46,7.88,92
1783910028,RAS401,27,50,7.88,77
1783910028,RVE401,29,51,7.88,80
1783910028,REC405,26,47,7.88,73
1783910028,RCS401,20,51,7.88,71
1783910028,RCS402,18,40,7.88,58
1783910028,RCS403,25,38,7.88,63
1783910028,RCS451,40,44,7.88,84
1783910028,RCS452,39,47,7.88,86
1783910028,RCS453,45,45,7.88,90
1783910028,RCS454,37,40,7.88,77
1783910028,RAS501,28,45,7.96,73
1783910028,RUC501,22,49,7.96,71
1783910028,RCS501,27,54,7.96,81
1783910028,RCS502,17,31,7.96,48
1783910028,RCS503,26,40,7.96,66
1783910028,RCS052,29,56,7.96,85
1783910028,RCS551,47,47,7.96,94
1783910028,RCS552,40,42,7.96,82
1783910028,RCS553,48,49,7.96,97
1783910028,RCS554,46,44,7.96,90
1783910028,RAS601,29,52,8.38,81
1783910028,RAS602,29,52,8.38,81
1783910028,RCS601,22,47,8.38,69
1783910028,RCS602,29,52,8.38,81
1783910028,RCS603,26,50,8.38,76
1783910028,RCS061,21,47,8.38,68
1783910028,RCS651,30,41,8.38,71
1783910028,RCS652,47,46,8.38,93
1783910028,RCS653,46,46,8.38,92
1783910028,RCS654,45,46,8.38,91
1783910028,ROE072,28,37,7.92,65
1783910028,RCS071,24,47,7.92,71
1783910028,RCS078,26,47,7.92,73
1783910028,RCS701,25,44,7.92,69
1783910028,RCS702,24,42,7.92,66
1783910028,RCS751,46,47,7.92,93
1783910028,RCS752,40,44,7.92,84
1783910028,RCS753,83,0,7.92,83
1783910028,RCS754,172,0,7.92,172
1783910029,RAS101,22,40,8.0,62
1783910029,REC101,29,43,8.0,72
1783910029,RAS103,23,56,8.0,79
1783910029,REE101,21,52,8.0,73
1783910029,RAS104,22,44,8.0,66
1783910029,RAS151,39,41,8.0,80
1783910029,REE151,45,41,8.0,86
1783910029,RAS154,45,44,8.0,89
1783910029,RME152,47,44,8.0,91
1783910029,RAS203,28,39,7.54,67
1783910029,RAS201,19,50,7.54,69
1783910029,RME201,26,33,7.54,59
1783910029,RCS201,26,44,7.54,70
1783910029,RAS202,28,35,7.54,63
1783910029,RAS252,46,47,7.54,93
1783910029,RME251,45,42,7.54,87
1783910029,RCS251,47,46,7.54,93
1783910029,RCE251,48,46,7.54,94
1783910029,ROE037,24,43,7.58,67
1783910029,RAS302,21,47,7.58,68
1783910029,REC301,30,31,7.58,61
1783910029,RCS301,26,50,7.58,76
1783910029,RCS302,27,40,7.58,67
1783910029,RCS305,23,45,7.58,68
1783910029,REC351,47,47,7.58,94
1783910029,RCS351,46,49,7.58,95
1783910029,RCS352,40,41,7.58,81
1783910029,RCS355,45,47,7.58,92
1783910029,RAS401,26,50,8.0,76
1783910029,RVE401,29,52,8.0,81
1783910029,REC405,27,34,8.0,61
1783910029,RCS401,28,52,8.0,80
1783910029,RCS402,22,40,8.0,62
1783910029,RCS403,25,32,8.0,57
1783910029,RCS451,48,42,8.0,90
1783910029,RCS452,48,45,8.0,93
1783910029,RCS453,45,47,8.0,92
1783910029,RCS454,48,48,8.0,96
1783910029,RAS501,29,48,7.88,77
1783910029,RUC501,23,54,7.88,77
1783910029,RCS501,26,48,7.88,74
1783910029,RCS502,16,47,7.88,63
1783910029,RCS503,27,50,7.88,77
1783910029,RCS052,26,42,7.88,68
1783910029,RCS551,46,46,7.88,92
1783910029,RCS552,38,41,7.88,79
1783910029,RCS553,48,48,7.88,96
1783910029,RCS554,44,45,7.88,89
1783910029,RAS601,28,52,8.63,80
1783910029,RAS602,28,52,8.63,80
1783910029,RCS601,24,49,8.63,73
1783910029,RCS602,30,53,8.63,83
1783910029,RCS603,28,52,8.63,80
1783910029,RCS061,22,47,8.63,69
1783910029,RCS651,33,42,8.63,75
1783910029,RCS652,49,47,8.63,96
1783910029,RCS653,47,46,8.63,93
1783910029,RCS654,45,46,8.63,91
1783910029,ROE072,27,41,8.08,68
1783910029,RCS071,28,50,8.08,78
1783910029,RCS078,26,47,8.08,73
1783910029,RCS701,23,50,8.08,73
1783910029,RCS702,26,50,8.08,76
1783910029,RCS751,45,44,8.08,89
1783910029,RCS752,43,41,8.08,84
1783910029,RCS753,76,0,8.08,76
1783910029,RCS754,169,0,8.08,169
1783910030,RAS101,22,44,7.92,66
1783910030,REC101,27,35,7.92,62
1783910030,RAS103,21,58,7.92,79
1783910030,REE101,18,53,7.92,71
1783910030,RAS104,21,52,7.92,73
1783910030,RAS151,37,39,7.92,76
1783910030,REE151,44,41,7.92,85
1783910030,RAS154,44,40,7.92,84
1783910030,RME152,46,44,7.92,90
1783910030,RAS203,26,63,7.83,89
1783910030,RAS201,25,45,7.83,70
1783910030,RME201,25,35,7.83,60
1783910030,RCS201,21,36,7.83,57
1783910030,RAS202,25,36,7.83,61
1783910030,RAS252,44,46,7.83,90
1783910030,RME251,44,42,7.83,86
1783910030,RCS251,43,44,7.83,87
1783910030,RCE251,44,44,7.83,88
1783910030,ROE037,20,26,7.58,46
1783910030,RAS302,19,44,7.58,63
1783910030,REC301,30,52,7.58,82
1783910030,RCS301,26,46,7.58,72
1783910030,RCS302,26,55,7.58,81
1783910030,RCS305,22,34,7.58,56
1783910030,REC351,47,49,7.58,96
1783910030,RCS351,46,47,7.58,93
1783910030,RCS352,43,42,7.58,85
1783910030,RCS355,44,47,7.58,91
1783910030,RAS401,19,53,7.88,72
1783910030,RVE401,28,52,7.88,80
1783910030,REC405,19,42,7.88,61
1783910030,RCS401,25,52,7.88,77
1783910030,RCS402,20,45,7.88,65
1783910030,RCS403,21,39,7.88,60
1783910030,RCS451,45,41,7.88,86
1783910030,RCS452,46,40,7.88,86
1783910030,RCS453,42,44,7.88,86
1783910030,RCS454,49,38,7.88,87
1783910030,RAS501,23,44,7.54,67
1783910030,RUC501,23,49,7.54,72
1783910030,RCS501,25,54,7.54,79
1783910030,RCS502,13,40,7.54,53
1783910030,RCS503,29,30,7.54,59
1783910030,RCS052,27,51,7.54,78
1783910030,RCS551,46,46,7.54,92
1783910030,RCS552,34,38,7.54,72
1783910030,RCS553,49,49,7.54,98
1783910030,RCS554,45,45,7.54,90
1783910030,RAS601,29,52,8.42,81
1783910030,RAS602,29,52,8.42,81
1783910030,RCS601,21,47,8.42,68
1783910030,RCS602,28,52,8.42,80
1783910030,RCS603,26,50,8.42,76
1783910030,RCS061,22,47,8.42,69
1783910030,RCS651,40,43,8.42,83
1783910030,RCS652,47,45,8.42,92
1783910030,RCS653,46,45,8.42,91
1783910030,RCS654,45,45,8.42,90
1783910030,ROE072,27,34,8.21,61
1783910030,RCS071,26,54,8.21,80
1783910030,RCS078,27,49,8.21,76
1783910030,RCS701,25,47,8.21,72
1783910030,RCS702,24,43,8.21,67
1783910030,RCS751,46,45,8.21,91
1783910030,RCS752,40,43,8.21,83
1783910030,RCS753,84,0,8.21,84
1783910030,RCS754,171,0,8.21,171
1783910031,RAS101,21,40,7.08,61
1783910031,REC101,19,28,7.08,47
1783910031,RAS103,26,54,7.08,80
1783910031,REE101,17,38,7.08,55
1783910031,RAS104,17,33,7.08,50
1783910031,RAS151,36,38,7.08,74
1783910031,REE151,42,40,7.08,82
1783910031,RAS154,42,43,7.08,85
1783910031,RME152,43,41,7.08,84
1783910031,RAS203,22,49,6.33,71
1783910031,RAS201,15,42,6.33,57
1783910031,RME201,19,29,6.33,48
1783910031,RCS201,19,33,6.33,52
1783910031,RAS202,15,30,6.33,45
1783910031,RAS252,38,42,6.33,80
1783910031,RME251,30,39,6.33,69
1783910031,RCS251,37,40,6.33,77
1783910031,RCE251,30,30,6.33,60
1783910031,ROE037,19,40,6.71,59
1783910031,RAS302,18,30,6.71,48
1783910031,REC301,15,38,6.71,53
1783910031,RCS301,19,49,6.71,68
1783910031,RCS302,14,49,6.71,63
1783910031,RCS305,19,41,6.71,60
1783910031,REC351,40,45,6.71,85
1783910031,RCS351,37,45,6.71,82
1783910031,RCS352,32,34,6.71,66
1783910031,RCS355,40,44,6.71,84
1783910031,RAS401,26,55,6.71,81
1783910031,RVE401,26,39,6.71,65
1783910031,REC405,13,46,6.71,59
1783910031,RCS401,13,47,6.71,60
1783910031,RCS402,13,27,6.71,40
1783910031,RCS403,15,30,6.71,45
1783910031,RCS451,33,44,6.71,77
1783910031,RCS452,35,42,6.71,77
1783910031,RCS453,41,42,6.71,83
1783910031,RCS454,36,35,6.71,71
1783910031,RAS501,30,47,7.0,77
1783910031,RUC501,23,49,7.0,72
1783910031,RCS501,25,41,7.0,66
1783910031,RCS502,15,28,7.0,43
1783910031,RCS503,25,32,7.0,57
1783910031,RCS052,26,39,7.0,65
1783910031,RCS551,45,45,7.0,90
1783910031,RCS552,36,35,7.0,71
1783910031,RCS553,47,47,7.0,94
1783910031,RCS554,43,43,7.0,86
1783910031,RAS601,27,47,7.83,74
1783910031,RAS602,26,46,7.83,72
1783910031,RCS601,19,41,7.83,60
1783910031,RCS602,27,47,7.83,74
1783910031,RCS603,25,46,7.83,71
1783910031,RCS061,22,43,7.83,65
1783910031,RCS651,34,39,7.83,73
1783910031,RCS652,46,43,7.83,89
1783910031,RCS653,45,43,7.83,88
1783910031,RCS654,45,43,7.83,88
1783910031,ROE072,23,36,7.46,59
1783910031,RCS071,22,50,7.46,72
1783910031,RCS078,27,35,7.46,62
1783910031,RCS701,27,35,7.46,62
1783910031,RCS702,24,30,7.46,54
1783910031,RCS751,48,41,7.46,89
1783910031,RCS752,40,43,7.46,83
1783910031,RCS753,84,0,7.46,84
1783910031,RCS754,170,0,7.46,170
1783910032,RAS101,17,44,6.25,61
1783910032,REC101,18,22,6.25,40
1783910032,RAS103,20,30,6.25,50
1783910032,REE101,15,33,6.25,48
1783910032,RAS104,19,35,6.25,54
1783910032,RAS151,35,40,6.25,75
1783910032,REE151,42,38,6.25,80
1783910032,RAS154,42,38,6.25,80
1783910032,RME152,44,42,6.25,86
1783910032,RAS203,19,37,5.92,56
1783910032,RAS201,15,25,5.92,40
1783910032,RME201,22,37,5.92,59
1783910032,RCS201,19,34,5.92,53
1783910032,RAS202,15,29,5.92,44
1783910032,RAS252,40,42,5.92,82
1783910032,RME251,43,38,5.92,81
1783910032,RCS251,37,42,5.92,79
1783910032,RCE251,40,41,5.92,81
1783910032,ROE037,20,36,5.92,56
1783910032,RAS302,16,34,5.92,50
1783910032,REC301,16,41,5.92,57
1783910032,RCS301,21,45,5.92,66
1783910032,RCS302,19,16,5.92,35
1783910032,RCS305,22,33,5.92,55
1783910032,REC351,42,42,5.92,84
1783910032,RCS351,42,45,5.92,87
1783910032,RCS352,40,42,5.92,82
1783910032,RCS355,44,46,5.92,90
1783910032,RAS401,15,39,6.38,54
1783910032,RVE401,23,30,6.38,53
1783910032,REC405,15,26,6.38,41
1783910032,RCS401,20,41,6.38,61
1783910032,RCS402,14,49,6.38,63
1783910032,RCS403,18,29,6.38,47
1783910032,RCS451,40,40,6.38,80
1783910032,RCS452,42,40,6.38,82
1783910032,RCS453,47,48,6.38,95
1783910032,RCS454,42,40,6.38,82
1783910033,RAS101,23,48,7.5,71
1783910033,REC101,26,41,7.5,67
1783910033,RAS103,21,29,7.5,50
1783910033,REE101,15,45,7.5,60
1783910033,RAS104,20,53,7.5,73
1783910033,RAS151,37,42,7.5,79
1783910033,REE151,42,39,7.5,81
1783910033,RAS154,42,46,7.5,88
1783910033,RME152,46,41,7.5,87
1783910033,RAS203,18,37,7.04,55
1783910033,RAS201,15,46,7.04,61
1783910033,RME201,22,38,7.04,60
1783910033,RCS201,19,35,7.04,54
1783910033,RAS202,18,50,7.04,68
1783910033,RAS252,42,44,7.04,86
1783910033,RME251,41,43,7.04,84
1783910033,RCS251,40,42,7.04,82
1783910033,RCE251,39,40,7.04,79
1783910033,ROE037,22,37,7.04,59
1783910033,RAS302,23,48,7.04,71
1783910033,REC301,20,39,7.04,59
1783910033,RCS301,21,43,7.04,64
1783910033,RCS302,27,43,7.04,70
1783910033,RCS305,20,29,7.04,49
1783910033,REC351,49,42,7.04,91
1783910033,RCS351,43,46,7.04,89
1783910033,RCS352,43,44,7.04,87
1783910033,RCS355,45,47,7.04,92
1783910033,RAS401,18,48,6.75,66
1783910033,RVE401,28,34,6.75,62
1783910033,REC405,17,37,6.75,54
1783910033,RCS401,17,41,6.75,58
1783910033,RCS402,19,37,6.75,56
1783910033,RCS403,17,38,6.75,55
1783910033,RCS451,37,41,6.75,78
1783910033,RCS452,36,45,6.75,81
1783910033,RCS453,46,47,6.75,93
1783910033,RCS454,36,36,6.75,72
1783910033,RAS501,24,36,7.46,60
1783910033,RUC501,24,45,7.46,69
1783910033,RCS501,25,47,7.46,72
1783910033,RCS502,12,49,7.46,61
1783910033,RCS503,26,39,7.46,65
1783910033,RCS052,26,42,7.46,68
1783910033,RCS551,45,45,7.46,90
1783910033,RCS552,30,33,7.46,63
1783910033,RCS553,48,48,7.46,96
1783910033,RCS554,42,43,7.46,85
1783910033,RAS601,28,49,7.96,77
1783910033,RAS602,28,49,7.96,77
1783910033,RCS601,23,45,7.96,68
1783910033,RCS602,29,49,7.96,78
1783910033,RCS603,27,48,7.96,75
1783910033,RCS061,21,44,7.96,65
1783910033,RCS651,45,44,7.96,89
1783910033,RCS652,46,44,7.96,90
1783910033,RCS653,46,44,7.96,90
1783910033,RCS654,45,44,7.96,89
1783910033,ROE072,25,36,7.75,61
1783910033,RCS071,24,44,7.75,68
1783910033,RCS078,26,42,7.75,68
1783910033,RCS701,25,47,7.75,72
1783910033,RCS702,26,34,7.75,60
1783910033,RCS751,46,43,7.75,89
1783910033,RCS752,43,41,7.75,84
1783910033,RCS753,88,0,7.75,88
1783910033,RCS754,177,0,7.75,177
1783910034,RAS101,23,55,8.13,78
1783910034,REC101,27,59,8.13,86
1783910034,RAS103,22,40,8.13,62
1783910034,REE101,16,63,8.13,79
1783910034,RAS104,23,38,8.13,61
1783910034,RAS151,38,40,8.13,78
1783910034,REE151,42,40,8.13,82
1783910034,RAS154,42,42,8.13,84
1783910034,RME152,46,44,8.13,90
1783910034,RAS203,18,49,7.42,67
1783910034,RAS201,24,52,7.42,76
1783910034,RME201,21,42,7.42,63
1783910034,RCS201,27,33,7.42,60
1783910034,RAS202,18,48,7.42,66
1783910034,RAS252,40,43,7.42,83
1783910034,RME251,41,36,7.42,77
1783910034,RCS251,47,43,7.42,90
1783910034,RCE251,30,30,7.42,60
1783910034,ROE037,20,44,7.75,64
1783910034,RAS302,22,55,7.75,77
1783910034,REC301,23,39,7.75,62
1783910034,RCS301,26,55,7.75,81
1783910034,RCS302,21,41,7.75,62
1783910034,RCS305,20,43,7.75,63
1783910034,REC351,44,44,7.75,88
1783910034,RCS351,43,46,7.75,89
1783910034,RCS352,40,41,7.75,81
1783910034,RCS355,45,48,7.75,93
1783910034,RAS401,22,54,6.88,76
1783910034,RVE401,29,45,6.88,74
1783910034,REC405,15,45,6.88,60
1783910034,RCS401,14,32,6.88,46
1783910034,RCS402,21,31,6.88,52
1783910034,RCS403,17,29,6.88,46
1783910034,RCS451,34,42,6.88,76
1783910034,RCS452,34,47,6.88,81
1783910034,RCS453,46,46,6.88,92
1783910034,RCS454,38,35,6.88,73
1783910034,RAS501,23,42,8.08,65
1783910034,RUC501,25,56,8.08,81
1783910034,RCS501,24,48,8.08,72
1783910034,RCS502,12,52,8.08,64
1783910034,RCS503,26,55,8.08,81
1783910034,RCS052,27,50,8.08,77
1783910034,RCS551,44,44,8.08,88
1783910034,RCS552,30,33,8.08,63
1783910034,RCS553,48,48,8.08,96
1783910034,RCS554,41,44,8.08,85
1783910034,RAS601,26,51,7.88,77
1783910034,RAS602,27,52,7.88,79
1783910034,RCS601,12,41,7.88,53
1783910034,RCS602,28,53,7.88,81
1783910034,RCS603,25,51,7.88,76
1783910034,RCS061,20,47,7.88,67
1783910034,RCS651,33,39,7.88,72
1783910034,RCS652,46,43,7.88,89
1783910034,RCS653,44,42,7.88,86
1783910034,RCS654,45,43,7.88,88
1783910034,ROE072,27,42,8.17,69
1783910034,RCS071,29,52,8.17,81
1783910034,RCS078,27,49,8.17,76
1783910034,RCS701,25,46,8.17,71
1783910034,RCS702,24,41,8.17,65
1783910034,RCS751,46,43,8.17,89
1783910034,RCS752,40,42,8.17,82
1783910034,RCS753,86,0,8.17,86
1783910034,RCS754,176,0,8.17,176
1783910035,RAS101,21,46,7.83,67
1783910035,REC101,27,52,7.83,79
1783910035,RAS103,27,50,7.83,77
1783910035,REE101,20,50,7.83,70
1783910035,RAS104,26,32,7.83,58
1783910035,RAS151,37,40,7.83,77
1783910035,REE151,45,43,7.83,88
1783910035,RAS154,45,43,7.83,88
1783910035,RME152,46,46,7.83,92
1783910035,RAS203,27,49,7.33,76
1783910035,RAS201,21,46,7.33,67
1783910035,RME201,29,30,7.33,59
1783910035,RCS201,25,26,7.33,51
1783910035,RAS202,25,33,7.33,58
1783910035,RAS252,45,47,7.33,92
1783910035,RME251,47,45,7.33,92
1783910035,RCS251,45,45,7.33,90
1783910035,RCE251,48,46,7.33,94
1783910035,ROE037,27,46,8.25,73
1783910035,RAS302,25,49,8.25,74
1783910035,REC301,25,52,8.25,77
1783910035,RCS301,19,55,8.25,74
1783910035,RCS302,28,60,8.25,88
1783910035,RCS305,25,43,8.25,68
1783910035,REC351,48,47,8.25,95
1783910035,RCS351,43,48,8.25,91
1783910035,RCS352,42,43,8.25,85
1783910035,RCS355,46,47,8.25,93
1783910035,RAS401,26,59,7.75,85
1783910035,RVE401,29,43,7.75,72
1783910035,REC405,26,46,7.75,72
1783910035,RCS401,24,50,7.75,74
1783910035,RCS402,18,38,7.75,56
1783910035,RCS403,26,24,7.75,50
1783910035,RCS451,44,42,7.75,86
1783910035,RCS452,36,42,7.75,78
1783910035,RCS453,45,45,7.75,90
1783910035,RCS454,46,40,7.75,86
1783910035,RAS501,29,38,7.63,67
1783910035,RUC501,24,46,7.63,70
1783910035,RCS501,25,50,7.63,75
1783910035,RCS502,25,35,7.63,60
1783910035,RCS503,28,29,7.63,57
1783910035,RCS052,27,39,7.63,66
1783910035,RCS551,46,47,7.63,93
1783910035,RCS552,49,48,7.63,97
1783910035,RCS553,49,49,7.63,98
1783910035,RCS554,47,47,7.63,94
1783910035,RAS601,28,51,8.13,79
1783910035,RAS602,28,51,8.13,79
1783910035,RCS601,18,44,8.13,62
1783910035,RCS602,29,51,8.13,80
1783910035,RCS603,26,49,8.13,75
1783910035,RCS061,20,45,8.13,65
1783910035,RCS651,31,41,8.13,72
1783910035,RCS652,49,47,8.13,96
1783910035,RCS653,45,46,8.13,91
1783910035,RCS654,45,46,8.13,91
1783910035,ROE072,25,35,7.88,60
1783910035,RCS071,22,49,7.88,71
1783910035,RCS078,28,41,7.88,69
1783910035,RCS701,27,47,7.88,74
1783910035,RCS702,24,39,7.88,63
1783910035,RCS751,48,41,7.88,89
1783910035,RCS752,40,42,7.88,82
1783910035,RCS753,89,0,7.88,89
1783910035,RCS754,179,0,7.88,179
1783910036,RAS101,28,50,7.71,78
1783910036,REC101,24,38,7.71,62
1783910036,RAS103,23,54,7.71,77
1783910036,REE101,15,44,7.71,59
1783910036,RAS104,20,43,7.71,63
1783910036,RAS151,48,48,7.71,96
1783910036,REE151,42,48,7.71,90
1783910036,RAS154,42,48,7.71,90
1783910036,RME152,44,43,7.71,87
1783910036,RAS203,25,49,7.54,74
1783910036,RAS201,21,50,7.54,71
1783910036,RME201,21,29,7.54,50
1783910036,RCS201,27,28,7.54,55
1783910036,RAS202,28,36,7.54,64
1783910036,RAS252,46,48,7.54,94
1783910036,RME251,44,40,7.54,84
1783910036,RCS251,47,45,7.54,92
1783910036,RCE251,43,42,7.54,85
1783910036,ROE037,21,48,7.38,69
1783910036,RAS302,22,47,7.38,69
1783910036,REC301,30,40,7.38,70
1783910036,RCS301,23,50,7.38,73
1783910036,RCS302,22,34,7.38,56
1783910036,RCS305,26,32,7.38,58
1783910036,REC351,46,48,7.38,94
1783910036,RCS351,43,45,7.38,88
1783910036,RCS352,46,45,7.38,91
1783910036,RCS355,42,47,7.38,89
1783910036,RAS401,25,41,7.0,66
1783910036,RVE401,28,28,7.0,56
1783910036,REC405,18,46,7.0,64
1783910036,RCS401,25,34,7.0,59
1783910036,RCS402,15,39,7.0,54
1783910036,RCS403,26,38,7.0,64
1783910036,RCS451,45,41,7.0,86
1783910036,RCS452,44,40,7.0,84
1783910036,RCS453,45,45,7.0,90
1783910036,RCS454,45,44,7.0,89
1783910036,RAS501,26,51,7.54,77
1783910036,RUC501,24,28,7.54,52
1783910036,RCS501,26,46,7.54,72
1783910036,RCS502,15,51,7.54,66
1783910036,RCS503,25,29,7.54,54
1783910036,RCS052,26,51,7.54,77
1783910036,RCS551,46,46,7.54,92
1783910036,RCS552,36,39,7.54,75
1783910036,RCS553,47,47,7.54,94
1783910036,RCS554,44,42,7.54,86
1783910036,RAS601,28,49,7.92,77
1783910036,RAS602,28,49,7.92,77
1783910036,RCS601,21,44,7.92,65
1783910036,RCS602,29,49,7.92,78
1783910036,RCS603,26,47,7.92,73
1783910036,RCS061,21,44,7.92,65
1783910036,RCS651,36,43,7.92,79
1783910036,RCS652,49,47,7.92,96
1783910036,RCS653,45,46,7.92,91
1783910036,RCS654,44,45,7.92,89
1783910036,ROE072,25,36,7.75,61
1783910036,RCS071,24,48,7.75,72
1783910036,RCS078,26,46,7.75,72
1783910036,RCS701,25,44,7.75,69
1783910036,RCS702,24,32,7.75,56
1783910036,RCS751,46,42,7.75,88
1783910036,RCS752,40,43,7.75,83
1783910036,RCS753,84,0,7.75,84
1783910036,RCS754,176,0,7.75,176
1783910037,RAS101,17,38,6.75,55
1783910037,REC101,23,45,6.75,68
1783910037,RAS103,22,51,6.75,73
1783910037,REE101,15,28,6.75,43
1783910037,RAS104,19,31,6.75,50
1783910037,RAS151,37,40,6.75,77
1783910037,REE151,42,44,6.75,86
1783910037,RAS154,42,43,6.75,85
1783910037,RME152,44,42,6.75,86
1783910037,RAS203,17,37,5.79,54
1783910037,RAS201,15,26,5.79,41
1783910037,RME201,20,27,5.79,47
1783910037,RCS201,19,29,5.79,48
1783910037,RAS202,23,33,5.79,56
1783910037,RAS252,38,41,5.79,79
1783910037,RME251,35,38,5.79,73
1783910037,RCS251,36,40,5.79,76
1783910037,RCE251,36,35,5.79,71
1783910037,ROE037,18,35,6.67,53
1783910037,RAS302,17,36,6.67,53
1783910037,REC301,18,29,6.67,47
1783910037,RCS301,22,36,6.67,58
1783910037,RCS302,14,49,6.67,63
1783910037,RCS305,22,46,6.67,68
1783910037,REC351,44,40,6.67,84
1783910037,RCS351,43,45,6.67,88
1783910037,RCS352,36,39,6.67,75
1783910037,RCS355,45,47,6.67,92
1783910037,RAS401,11,43,6.54,54
1783910037,RVE401,25,43,6.54,68
1783910037,REC405,13,36,6.54,49
1783910037,RCS401,20,37,6.54,57
1783910037,RCS402,20,35,6.54,55
1783910037,RCS403,15,38,6.54,53
1783910037,RCS451,40,40,6.54,80
1783910037,RCS452,40,47,6.54,87
1783910037,RCS453,46,46,6.54,92
1783910037,RCS454,41,42,6.54,83
1783910037,RAS501,25,36,6.5,61
1783910037,RUC501,20,24,6.5,44
1783910037,RCS501,25,37,6.5,62
1783910037,RCS502,10,42,6.5,52
1783910037,RCS503,25,25,6.5,50
1783910037,RCS052,25,33,6.5,58
1783910037,RCS551,45,45,6.5,90
1783910037,RCS552,30,33,6.5,63
1783910037,RCS553,48,48,6.5,96
1783910037,RCS554,40,40,6.5,80
1783910037,RAS601,28,45,7.88,73
1783910037,RAS602,28,45,7.88,73
1783910037,RCS601,22,40,7.88,62
1783910037,RCS602,30,46,7.88,76
1783910037,RCS603,27,44,7.88,71
1783910037,RCS061,21,40,7.88,61
1783910037,RCS651,38,40,7.88,78
1783910037,RCS652,49,44,7.88,93
1783910037,RCS653,46,43,7.88,89
1783910037,RCS654,45,43,7.88,88
1783910037,ROE072,23,35,7.25,58
1783910037,RCS071,27,38,7.25,65
1783910037,RCS078,26,35,7.25,61
1783910037,RCS701,25,42,7.25,67
1783910037,RCS702,25,28,7.25,53
1783910037,RCS751,46,43,7.25,89
1783910037,RCS752,42,41,7.25,83
1783910037,RCS753,76,0,7.25,76
1783910037,RCS754,167,0,7.25,167
1783910038,RAS101,21,39,7.63,60
1783910038,REC101,22,34,7.63,56
1783910038,RAS103,28,70,7.63,98
1783910038,REE101,18,51,7.63,69
1783910038,RAS104,19,37,7.63,56
1783910038,RAS151,39,43,7.63,82
1783910038,REE151,43,39,7.63,82
1783910038,RAS154,43,45,7.63,88
1783910038,RME152,43,42,7.63,85
1783910038,RAS203,19,42,7.21,61
1783910038,RAS201,15,56,7.21,71
1783910038,RME201,21,39,7.21,60
1783910038,RCS201,20,28,7.21,48
1783910038,RAS202,17,44,7.21,61
1783910038,RAS252,39,44,7.21,83
1783910038,RME251,32,41,7.21,73
1783910038,RCS251,40,44,7.21,84
1783910038,RCE251,38,37,7.21,75
1783910038,ROE037,22,44,7.08,66
1783910038,RAS302,22,35,7.08,57
1783910038,REC301,25,36,7.08,61
1783910038,RCS301,20,48,7.08,68
1783910038,RCS302,20,31,7.08,51
1783910038,RCS305,23,38,7.08,61
1783910038,REC351,41,45,7.08,86
1783910038,RCS351,41,45,7.08,86
1783910038,RCS352,34,36,7.08,70
1783910038,RCS355,44,46,7.08,90
1783910038,RAS401,21,49,7.75,70
1783910038,RVE401,29,42,7.75,71
1783910038,REC405,23,50,7.75,73
1783910038,RCS401,20,46,7.75,66
1783910038,RCS402,13,50,7.75,63
1783910038,RCS403,22,40,7.75,62
1783910038,RCS451,40,44,7.75,84
1783910038,RCS452,43,45,7.75,88
1783910038,RCS453,43,44,7.75,87
1783910038,RCS454,43,46,7.75,89
1783910038,RAS501,25,40,6.83,65
1783910038,RUC501,19,52,6.83,71
1783910038,RCS501,25,28,6.83,53
1783910038,RCS502,12,31,6.83,43
1783910038,RCS503,24,38,6.83,62
1783910038,RCS052,25,37,6.83,62
1783910038,RCS551,45,45,6.83,90
1783910038,RCS552,30,33,6.83,63
1783910038,RCS553,48,48,6.83,96
1783910038,RCS554,40,40,6.83,80
1783910038,RAS601,28,49,7.83,77
1783910038,RAS602,27,48,7.83,75
1783910038,RCS601,22,44,7.83,66
1783910038,RCS602,27,48,7.83,75
1783910038,RCS603,25,47,7.83,72
1783910038,RCS061,19,42,7.83,61
1783910038,RCS651,34,40,7.83,74
1783910038,RCS652,44,43,7.83,87
1783910038,RCS653,45,44,7.83,89
1783910038,RCS654,45,44,7.83,89
1783910038,ROE072,25,38,7.29,63
1783910038,RCS071,26,47,7.29,73
1783910038,RCS078,26,42,7.29,68
1783910038,RCS701,25,33,7.29,58
1783910038,RCS702,22,37,7.29,59
1783910038,RCS751,46,42,7.29,88
1783910038,RCS752,37,41,7.29,78
1783910038,RCS753,72,0,7.29,72
1783910038,RCS754,168,0,7.29,168
1783910039,RAS101,24,40,7.5,64
1783910039,REC101,26,38,7.5,64
1783910039,RAS103,21,47,7.5,68
1783910039,REE101,17,46,7.5,63
1783910039,RAS104,20,45,7.5,65
1783910039,RAS151,40,44,7.5,84
1783910039,REE151,44,40,7.5,84
1783910039,RAS154,44,40,7.5,84
1783910039,RME152,45,46,7.5,91
1783910039,RAS203,19,26,6.79,45
1783910039,RAS201,15,48,6.79,63
1783910039,RME201,22,48,6.79,70
1783910039,RCS201,19,26,6.79,45
1783910039,RAS202,17,36,6.79,53
1783910039,RAS252,42,45,6.79,87
1783910039,RME251,43,35,6.79,78
1783910039,RCS251,38,42,6.79,80
1783910039,RCE251,43,42,6.79,85
1783910039,ROE037,22,44,6.79,66
1783910039,RAS302,19,57,6.79,76
1783910039,REC301,20,33,6.79,53
1783910039,RCS301,25,33,6.79,58
1783910039,RCS302,21,48,6.79,69
1783910039,RCS305,19,21,6.79,40
1783910039,REC351,45,45,6.79,90
1783910039,RCS351,42,45,6.79,87
1783910039,RCS352,37,45,6.79,82
1783910039,RCS355,45,47,6.79,92
1783910039,RAS401,22,33,7.33,55
1783910039,RVE401,27,46,7.33,73
1783910039,REC405,24,46,7.33,70
1783910039,RCS401,24,49,7.33,73
1783910039,RCS402,19,40,7.33,59
1783910039,RCS403,21,36,7.33,57
1783910039,RCS451,44,41,7.33,85
1783910039,RCS452,46,44,7.33,90
1783910039,RCS453,41,42,7.33,83
1783910039,RCS454,46,48,7.33,94
1783910039,RAS501,28,40,7.21,68
1783910039,RUC501,20,35,7.21,55
1783910039,RCS501,26,51,7.21,77
1783910039,RCS502,14,47,7.21,61
1783910039,RCS503,25,26,7.21,51
1783910039,RCS052,24,42,7.21,66
1783910039,RCS551,46,46,7.21,92
1783910039,RCS552,30,35,7.21,65
1783910039,RCS553,46,46,7.21,92
1783910039,RCS554,39,44,7.21,83
1783910039,RAS601,29,49,7.96,78
1783910039,RAS602,29,49,7.96,78
1783910039,RCS601,18,42,7.96,60
1783910039,RCS602,29,49,7.96,78
1783910039,RCS603,27,48,7.96,75
1783910039,RCS061,20,43,7.96,63
1783910039,RCS651,30,40,7.96,70
1783910039,RCS652,49,46,7.96,95
1783910039,RCS653,46,45,7.96,91
1783910039,RCS654,45,45,7.96,90
1783910039,ROE072,25,36,7.83,61
1783910039,RCS071,22,52,7.83,74
1783910039,RCS078,26,36,7.83,62
1783910039,RCS701,23,48,7.83,71
1783910039,RCS702,28,40,7.83,68
1783910039,RCS751,45,44,7.83,89
1783910039,RCS752,47,44,7.83,91
1783910039,RCS753,78,0,7.83,78
1783910039,RCS754,169,0,7.83,169
1783910040,RAS101,23,36,7.5,59
1783910040,REC101,25,50,7.5,75
1783910040,RAS103,25,36,7.5,61
1783910040,REE101,18,50,7.5,68
1783910040,RAS104,28,40,7.5,68
1783910040,RAS151,41,44,7.5,85
1783910040,REE151,44,40,7.5,84
1783910040,RAS154,44,45,7.5,89
1783910040,RME152,46,44,7.5,90
1783910040,RAS203,25,42,7.96,67
1783910040,RAS201,23,56,7.96,79
1783910040,RME201,23,48,7.96,71
1783910040,RCS201,21,46,7.96,67
1783910040,RAS202,28,42,7.96,70
1783910040,RAS252,44,47,7.96,91
1783910040,RME251,43,41,7.96,84
1783910040,RCS251,43,43,7.96,86
1783910040,RCE251,43,42,7.96,85
1783910040,ROE037,23,50,7.46,73
1783910040,RAS302,21,42,7.46,63
1783910040,REC301,24,34,7.46,58
1783910040,RCS301,21,36,7.46,57
1783910040,RCS302,22,45,7.46,67
1783910040,RCS305,21,53,7.46,74
1783910040,REC351,42,45,7.46,87
1783910040,RCS351,42,45,7.46,87
1783910040,RCS352,42,43,7.46,85
1783910040,RCS355,44,47,7.46,91
1783910040,RAS401,27,53,7.96,80
1783910040,RVE401,30,58,7.96,88
1783910040,REC405,27,46,7.96,73
1783910040,RCS401,24,55,7.96,79
1783910040,RCS402,19,36,7.96,55
1783910040,RCS403,26,29,7.96,55
1783910040,RCS451,44,42,7.96,86
1783910040,RCS452,45,47,7.96,92
1783910040,RCS453,44,45,7.96,89
1783910040,RCS454,46,47,7.96,93
1783910040,RAS501,29,42,7.83,71
1783910040,RUC501,22,48,7.83,70
1783910040,RCS501,27,48,7.83,75
1783910040,RCS502,15,47,7.83,62
1783910040,RCS503,30,48,7.83,78
1783910040,RCS052,25,40,7.83,65
1783910040,RCS551,47,47,7.83,94
1783910040,RCS552,32,35,7.83,67
1783910040,RCS553,47,47,7.83,94
1783910040,RCS554,40,42,7.83,82
1783910040,RAS601,29,52,8.21,81
1783910040,RAS602,29,52,8.21,81
1783910040,RCS601,20,46,8.21,66
1783910040,RCS602,27,51,8.21,78
1783910040,RCS603,26,50,8.21,76
1783910040,RCS061,21,47,8.21,68
1783910040,RCS651,30,40,8.21,70
1783910040,RCS652,46,45,8.21,91
1783910040,RCS653,46,45,8.21,91
1783910040,RCS654,46,45,8.21,91
1783910040,ROE072,27,41,8.46,68
1783910040,RCS071,26,50,8.46,76
1783910040,RCS078,26,48,8.46,74
1783910040,RCS701,27,58,8.46,85
1783910040,RCS702,28,60,8.46,88
1783910040,RCS751,48,41,8.46,89
1783910040,RCS752,47,41,8.46,88
1783910040,RCS753,86,0,8.46,86
1783910040,RCS754,174,0,8.46,174
1783910041,ROE037,19,41,6.58,60
1783910041,RAS302,17,33,6.58,50
1783910041,REC301,17,32,6.58,49
1783910041,RCS301,24,21,6.58,45
1783910041,RCS302,26,36,6.58,62
1783910041,RCS305,20,33,6.58,53
1783910041,REC351,45,39,6.58,84
1783910041,RCS351,43,45,6.58,88
1783910041,RCS352,43,44,6.58,87
1783910041,RCS355,44,48,6.58,92
1783910041,RAS401,12,37,6.38,49
1783910041,RVE401,27,31,6.38,58
1783910041,REC405,18,34,6.38,52
1783910041,RCS401,23,42,6.38,65
1783910041,RCS402,19,35,6.38,54
1783910041,RCS403,23,26,6.38,49
1783910041,RCS451,43,40,6.38,83
1783910041,RCS452,44,47,6.38,91
1783910041,RCS453,48,49,6.38,97
1783910041,RCS454,43,42,6.38,85
1783910041,RAS501,26,35,6.25,61
1783910041,RUC501,19,30,6.25,49
1783910041,RCS501,23,31,6.25,54
1783910041,RCS502,12,30,6.25,42
1783910041,RCS503,26,25,6.25,51
1783910041,RCS052,26,40,6.25,66
1783910041,RCS551,43,43,6.25,86
1783910041,RCS552,33,33,6.25,66
1783910041,RCS553,47,47,6.25,94
1783910041,RCS554,41,37,6.25,78
1783910041,RAS601,28,42,7.25,70
1783910041,RAS602,28,42,7.25,70
1783910041,RCS601,21,37,7.25,58
1783910041,RCS602,27,41,7.25,68
1783910041,RCS603,25,40,7.25,65
1783910041,RCS061,20,36,7.25,56
1783910041,RCS651,38,40,7.25,78
1783910041,RCS652,46,43,7.25,89
1783910041,RCS653,42,42,7.25,84
1783910041,RCS654,45,43,7.25,88
1783910041,RAS101,15,19,5.0,34
1783910041,REC101,18,27,5.0,45
1783910041,RAS103,19,23,5.0,42
1783910041,REE101,15,38,5.0,53
1783910041,RAS104,18,29,5.0,47
1783910041,RAS151,39,41,5.0,80
1783910041,REE151,42,38,5.0,80
1783910041,RAS154,42,44,5.0,86
1783910041,RME152,44,45,5.0,89
1783910041,RAS203,16,26,5.54,42
1783910041,RAS201,15,35,5.54,50
1783910041,RME201,20,24,5.54,44
1783910041,RCS201,23,29,5.54,52
1783910041,RAS202,15,27,5.54,42
1783910041,RAS252,38,40,5.54,78
1783910041,RME251,40,35,5.54,75
1783910041,RCS251,44,40,5.54,84
1783910041,RCE251,44,43,5.54,87
1783910041,ROE072,23,39,7.63,62
1783910041,RCS071,24,44,7.63,68
1783910041,RCS078,25,45,7.63,70
1783910041,RCS701,27,32,7.63,59
1783910041,RCS702,22,45,7.63,67
1783910041,RCS751,48,45,7.63,93
1783910041,RCS752,37,43,7.63,80
1783910041,RCS753,82,0,7.63,82
1783910041,RCS754,169,0,7.63,169
1783910042,RAS101,22,41,6.96,63
1783910042,REC101,22,24,6.96,46
1783910042,RAS103,23,44,6.96,67
1783910042,REE101,17,50,6.96,67
1783910042,RAS104,18,40,6.96,58
1783910042,RAS151,40,42,6.96,82
1783910042,REE151,42,38,6.96,80
1783910042,RAS154,42,39,6.96,81
1783910042,RME152,39,42,6.96,81
1783910042,RAS203,16,32,6.38,48
1783910042,RAS201,15,45,6.38,60
1783910042,RME201,19,46,6.38,65
1783910042,RCS201,20,27,6.38,47
1783910042,RAS202,19,29,6.38,48
1783910042,RAS252,38,41,6.38,79
1783910042,RME251,30,39,6.38,69
1783910042,RCS251,42,39,6.38,81
1783910042,RCE251,40,42,6.38,82
1783910042,ROE037,18,30,5.96,48
1783910042,RAS302,16,27,5.96,43
1783910042,REC301,15,25,5.96,40
1783910042,RCS301,24,47,5.96,71
1783910042,RCS302,19,31,5.96,50
1783910042,RCS305,22,26,5.96,48
1783910042,REC351,40,45,5.96,85
1783910042,RCS351,42,45,5.96,87
1783910042,RCS352,41,44,5.96,85
1783910042,RCS355,43,47,5.96,90
1783910042,RAS401,9,41,5.0,50
1783910042,RVE401,26,29,5.0,55
1783910042,REC405,13,22,5.0,35
1783910042,RCS401,12,38,5.0,50
1783910042,RCS402,12,28,5.0,40
1783910042,RCS403,13,27,5.0,40
1783910042,RCS451,32,41,5.0,73
1783910042,RCS452,37,45,5.0,82
1783910042,RCS453,38,40,5.0,78
1783910042,RCS454,37,30,5.0,67
1783910042,RAS501,23,31,6.17,54
1783910042,RUC501,20,31,6.17,51
1783910042,RCS501,22,33,6.17,55
1783910042,RCS502,9,33,6.17,42
1783910042,RCS503,25,40,6.17,65
1783910042,RCS052,22,29,6.17,51
1783910042,RCS551,42,42,6.17,84
1783910042,RCS552,30,33,6.17,63
1783910042,RCS553,46,46,6.17,92
1783910042,RCS554,34,33,6.17,67
1783910042,RAS601,29,44,7.0,73
1783910042,RAS602,28,44,7.0,72
1783910042,RCS601,16,35,7.0,51
1783910042,RCS602,20,38,7.0,58
1783910042,RCS603,22,39,7.0,61
1783910042,RCS061,20,38,7.0,58
1783910042,RCS651,30,38,7.0,68
1783910042,RCS652,36,40,7.0,76
1783910042,RCS653,40,41,7.0,81
1783910042,RCS654,45,43,7.0,88
1783910042,ROE072,25,29,6.63,54
1783910042,RCS071,24,31,6.63,55
1783910042,RCS078,24,29,6.63,53
1783910042,RCS701,27,24,6.63,51
1783910042,RCS702,20,30,6.63,50
1783910042,RCS751,48,41,6.63,89
1783910042,RCS752,33,44,6.63,77
1783910042,RCS753,78,0,6.63,78
1783910042,RCS754,159,0,6.63,159
1783910043,RAS101,19,54,7.5,73
1783910043,REC101,25,35,7.5,60
1783910043,RAS103,28,41,7.5,69
1783910043,REE101,18,38,7.5,56
1783910043,RAS104,24,39,7.5,63
1783910043,RAS151,37,40,7.5,77
1783910043,REE151,43,48,7.5,91
1783910043,RAS154,43,45,7.5,88
1783910043,RME152,46,44,7.5,90
1783910043,RAS203,25,49,7.13,74
1783910043,RAS201,22,51,7.13,73
1783910043,RME201,23,32,7.13,55
1783910043,RCS201,19,29,7.13,48
1783910043,RAS202,19,38,7.13,57
1783910043,RAS252,38,40,7.13,78
1783910043,RME251,40,43,7.13,83
1783910043,RCS251,39,42,7.13,81
1783910043,RCE251,42,43,7.13,85
1783910043,ROE037,18,40,7.13,58
1783910043,RAS302,21,36,7.13,57
1783910043,REC301,21,43,7.13,64
1783910043,RCS301,20,50,7.13,70
1783910043,RCS302,21,44,7.13,65
1783910043,RCS305,19,36,7.13,55
1783910043,REC351,44,45,7.13,89
1783910043,RCS351,46,46,7.13,92
1783910043,RCS352,44,46,7.13,90
1783910043,RCS355,47,46,7.13,93
1783910043,RAS401,27,24,7.21,51
1783910043,RVE401,29,38,7.21,67
1783910043,REC405,19,41,7.21,60
1783910043,RCS401,20,47,7.21,67
1783910043,RCS402,19,45,7.21,64
1783910043,RCS403,25,35,7.21,60
1783910043,RCS451,40,42,7.21,82
1783910043,RCS452,40,43,7.21,83
1783910043,RCS453,45,47,7.21,92
1783910043,RCS454,40,40,7.21,80
1783910043,RAS501,29,45,7.21,74
1783910043,RUC501,22,50,7.21,72
1783910043,RCS501,27,40,7.21,67
1783910043,RCS502,16,35,7.21,51
1783910043,RCS503,27,27,7.21,54
1783910043,RCS052,24,33,7.21,57
1783910043,RCS551,47,47,7.21,94
1783910043,RCS552,42,49,7.21,91
1783910043,RCS553,46,46,7.21,92
1783910043,RCS554,36,42,7.21,78
1783910043,RAS601,29,48,7.92,77
1783910043,RAS602,27,47,7.92,74
1783910043,RCS601,19,41,7.92,60
1783910043,RCS602,27,47,7.92,74
1783910043,RCS603,26,46,7.92,72
1783910043,RCS061,23,44,7.92,67
1783910043,RCS651,32,42,7.92,74
1783910043,RCS652,46,46,7.92,92
1783910043,RCS653,44,45,7.92,89
1783910043,RCS654,47,46,7.92,93
1783910043,ROE072,23,37,7.17,60
1783910043,RCS071,24,30,7.17,54
1783910043,RCS078,27,37,7.17,64
1783910043,RCS701,25,32,7.17,57
1783910043,RCS702,24,27,7.17,51
1783910043,RCS751,46,43,7.17,89
1783910043,RCS752,40,46,7.17,86
1783910043,RCS753,80,0,7.17,80
1783910043,RCS754,174,0,7.17,174
1783910044,RAS101,20,55,7.88,75
1783910044,REC101,21,59,7.88,80
1783910044,RAS103,25,49,7.88,74
1783910044,REE101,18,40,7.88,58
1783910044,RAS104,18,39,7.88,57
1783910044,RAS151,40,42,7.88,82
1783910044,REE151,44,40,7.88,84
1783910044,RAS154,44,45,7.88,89
1783910044,RME152,45,45,7.88,90
1783910044,RAS203,24,42,6.46,66
1783910044,RAS201,19,50,6.46,69
1783910044,RME201,20,27,6.46,47
1783910044,RCS201,19,23,6.46,42
1783910044,RAS202,20,39,6.46,59
1783910044,RAS252,42,44,6.46,86
1783910044,RME251,39,38,6.46,77
1783910044,RCS251,40,38,6.46,78
1783910044,RCE251,42,44,6.46,86
1783910044,ROE037,18,33,6.21,51
1783910044,RAS302,17,29,6.21,46
1783910044,REC301,21,24,6.21,45
1783910044,RCS301,21,41,6.21,62
1783910044,RCS302,19,22,6.21,41
1783910044,RCS305,22,30,6.21,52
1783910044,REC351,42,45,6.21,87
1783910044,RCS351,43,48,6.21,91
1783910044,RCS352,40,42,6.21,82
1783910044,RCS355,46,47,6.21,93
1783910044,RAS401,23,36,6.54,59
1783910044,RVE401,23,34,6.54,57
1783910044,REC405,19,38,6.54,57
1783910044,RCS401,22,49,6.54,71
1783910044,RCS402,16,25,6.54,41
1783910044,RCS403,23,32,6.54,55
1783910044,RCS451,42,40,6.54,82
1783910044,RCS452,41,47,6.54,88
1783910044,RCS453,43,48,6.54,91
1783910044,RCS454,43,45,6.54,88
1783910044,RAS501,25,30,7.29,55
1783910044,RUC501,22,33,7.29,55
1783910044,RCS501,25,46,7.29,71
1783910044,RCS502,25,44,7.29,69
1783910044,RCS503,23,39,7.29,62
1783910044,RCS052,24,37,7.29,61
1783910044,RCS551,45,45,7.29,90
1783910044,RCS552,47,44,7.29,91
1783910044,RCS553,46,46,7.29,92
1783910044,RCS554,37,39,7.29,76
1783910044,RAS601,29,47,7.42,76
1783910044,RAS602,28,47,7.42,75
1783910044,RCS601,18,40,7.42,58
1783910044,RCS602,20,41,7.42,61
1783910044,RCS603,22,42,7.42,64
1783910044,RCS061,22,42,7.42,64
1783910044,RCS651,30,40,7.42,70
1783910044,RCS652,33,41,7.42,74
1783910044,RCS653,43,44,7.42,87
1783910044,RCS654,45,45,7.42,90
1783910044,ROE072,23,30,6.92,53
1783910044,RCS071,24,30,6.92,54
1783910044,RCS078,25,39,6.92,64
1783910044,RCS701,23,37,6.92,60
1783910044,RCS702,18,24,6.92,42
1783910044,RCS751,45,43,6.92,88
1783910044,RCS752,30,46,6.92,76
1783910044,RCS753,82,0,6.92,82
1783910044,RCS754,171,0,6.92,171
1783910045,RAS101,22,38,7.96,60
1783910045,REC101,25,52,7.96,77
1783910045,RAS103,23,60,7.96,83
1783910045,REE101,23,45,7.96,68
1783910045,RAS104,23,43,7.96,66
1783910045,RAS151,42,44,7.96,86
1783910045,REE151,45,44,7.96,89
1783910045,RAS154,45,47,7.96,92
1783910045,RME152,45,43,7.96,88
1783910045,RAS203,26,63,8.13,89
1783910045,RAS201,22,48,8.13,70
1783910045,RME201,25,47,8.13,72
1783910045,RCS201,28,48,8.13,76
1783910045,RAS202,23,33,8.13,56
1783910045,RAS252,44,47,8.13,91
1783910045,RME251,40,41,8.13,81
1783910045,RCS251,47,45,8.13,92
1783910045,RCE251,45,44,8.13,89
1783910045,ROE037,20,36,7.29,56
1783910045,RAS302,21,36,7.29,57
1783910045,REC301,29,31,7.29,60
1783910045,RCS301,28,46,7.29,74
1783910045,RCS302,28,46,7.29,74
1783910045,RCS305,23,35,7.29,58
1783910045,REC351,47,46,7.29,93
1783910045,RCS351,45,46,7.29,91
1783910045,RCS352,46,45,7.29,91
1783910045,RCS355,47,47,7.29,94
1783910045,RAS401,27,51,7.13,78
1783910045,RVE401,30,41,7.13,71
1783910045,REC405,26,43,7.13,69
1783910045,RCS401,25,43,7.13,68
1783910045,RCS402,13,37,7.13,50
1783910045,RCS403,19,27,7.13,46
1783910045,RCS451,45,43,7.13,88
1783910045,RCS452,46,43,7.13,89
1783910045,RCS453,40,41,7.13,81
1783910045,RCS454,47,30,7.13,77
1783910045,RAS501,28,47,7.75,75
1783910045,RUC501,22,50,7.75,72
1783910045,RCS501,26,36,7.75,62
1783910045,RCS502,27,35,7.75,62
1783910045,RCS503,28,34,7.75,62
1783910045,RCS052,27,38,7.75,65
1783910045,RCS551,47,48,7.75,95
1783910045,RCS552,50,50,7.75,100
1783910045,RCS553,49,49,7.75,98
1783910045,RCS554,48,47,7.75,95
1783910045,RAS601,29,50,7.71,79
1783910045,RAS602,28,50,7.71,78
1783910045,RCS601,21,45,7.71,66
1783910045,RCS602,20,44,7.71,64
1783910045,RCS603,21,45,7.71,66
1783910045,RCS061,24,47,7.71,71
1783910045,RCS651,44,45,7.71,89
1783910045,RCS652,31,41,7.71,72
1783910045,RCS653,34,42,7.71,76
1783910045,RCS654,49,47,7.71,96
1783910045,ROE072,23,28,7.38,51
1783910045,RCS071,30,32,7.38,62
1783910045,RCS078,26,42,7.38,68
1783910045,RCS701,27,34,7.38,61
1783910045,RCS702,24,32,7.38,56
1783910045,RCS751,48,46,7.38,94
1783910045,RCS752,40,46,7.38,86
1783910045,RCS753,83,0,7.38,83
1783910045,RCS754,174,0,7.38,174
1783910046,RAS101,25,41,7.88,66
1783910046,REC101,26,37,7.88,63
1783910046,RAS103,29,41,7.88,70
1783910046,REE101,22,53,7.88,75
1783910046,RAS104,23,42,7.88,65
1783910046,RAS151,44,48,7.88,92
1783910046,REE151,47,44,7.88,91
1783910046,RAS154,47,47,7.88,94
1783910046,RME152,44,44,7.88,88
1783910046,RAS203,27,40,7.71,67
1783910046,RAS201,23,56,7.71,79
1783910046,RME201,25,41,7.71,66
1783910046,RCS201,29,41,7.71,70
1783910046,RAS202,28,36,7.71,64
1783910046,RAS252,47,48,7.71,95
1783910046,RME251,40,43,7.71,83
1783910046,RCS251,49,44,7.71,93
1783910046,RCE251,44,34,7.71,78
1783910046,ROE037,20,41,8.0,61
1783910046,RAS302,22,58,8.0,80
1783910046,REC301,28,43,8.0,71
1783910046,RCS301,29,46,8.0,75
1783910046,RCS302,27,37,8.0,64
1783910046,RCS305,26,36,8.0,62
1783910046,REC351,46,46,8.0,92
1783910046,RCS351,48,46,8.0,94
1783910046,RCS352,49,48,8.0,97
1783910046,RCS355,49,48,8.0,97
1783910046,RAS401,30,51,7.63,81
1783910046,RVE401,29,38,7.63,67
1783910046,REC405,22,40,7.63,62
1783910046,RCS401,24,42,7.63,66
1783910046,RCS402,22,38,7.63,60
1783910046,RCS403,22,35,7.63,57
1783910046,RCS451,44,47,7.63,91
1783910046,RCS452,47,49,7.63,96
1783910046,RCS453,41,43,7.63,84
1783910046,RCS454,48,48,7.63,96
1783910046,RAS501,25,42,7.79,67
1783910046,RUC501,20,51,7.79,71
1783910046,RCS501,25,39,7.79,64
1783910046,RCS502,24,52,7.79,76
1783910046,RCS503,28,40,7.79,68
1783910046,RCS052,26,43,7.79,69
1783910046,RCS551,46,47,7.79,93
1783910046,RCS552,50,49,7.79,99
1783910046,RCS553,49,49,7.79,98
1783910046,RCS554,46,44,7.79,90
1783910046,RAS601,28,50,7.83,78
1783910046,RAS602,28,50,7.83,78
1783910046,RCS601,22,45,7.83,67
1783910046,RCS602,29,50,7.83,79
1783910046,RCS603,23,46,7.83,69
1783910046,RCS061,23,46,7.83,69
1783910046,RCS651,42,45,7.83,87
1783910046,RCS652,49,47,7.83,96
1783910046,RCS653,42,45,7.83,87
1783910046,RCS654,49,47,7.83,96
1783910046,ROE072,23,35,7.21,58
1783910046,RCS071,30,35,7.21,65
1783910046,RCS078,26,37,7.21,63
1783910046,RCS701,29,26,7.21,55
1783910046,RCS702,22,37,7.21,59
1783910046,RCS751,49,46,7.21,95
1783910046,RCS752,37,46,7.21,83
1783910046,RCS753,85,0,7.21,85
1783910046,RCS754,174,0,7.21,174
1783910048,RAS101,22,37,7.13,59
1783910048,REC101,23,35,7.13,58
1783910048,RAS103,24,59,7.13,83
1783910048,REE101,18,37,7.13,55
1783910048,RAS104,18,36,7.13,54
1783910048,RAS151,40,44,7.13,84
1783910048,REE151,45,38,7.13,83
1783910048,RAS154,45,38,7.13,83
1783910048,RME152,43,41,7.13,84
1783910048,RAS203,25,40,6.67,65
1783910048,RAS201,25,40,6.67,65
1783910048,RME201,20,21,6.67,41
1783910048,RCS201,19,31,6.67,50
1783910048,RAS202,15,48,6.67,63
1783910048,RAS252,40,43,6.67,83
1783910048,RME251,32,36,6.67,68
1783910048,RCS251,35,38,6.67,73
1783910048,RCE251,45,44,6.67,89
1783910048,ROE037,19,33,6.63,52
1783910048,RAS302,17,39,6.63,56
1783910048,REC301,18,29,6.63,47
1783910048,RCS301,20,53,6.63,73
1783910048,RCS302,21,29,6.63,50
1783910048,RCS305,22,32,6.63,54
1783910048,REC351,43,46,6.63,89
1783910048,RCS351,43,45,6.63,88
1783910048,RCS352,38,40,6.63,78
1783910048,RCS355,47,47,6.63,94
1783910048,RAS401,17,37,5.54,54
1783910048,RVE401,26,31,5.54,57
1783910048,REC405,13,32,5.54,45
1783910048,RCS401,17,23,5.54,40
1783910048,RCS402,14,35,5.54,49
1783910048,RCS403,16,28,5.54,44
1783910048,RCS451,37,38,5.54,75
1783910048,RCS452,37,45,5.54,82
1783910048,RCS453,38,41,5.54,79
1783910048,RCS454,39,40,5.54,79
1783910048,RAS501,22,26,6.08,48
1783910048,RUC501,19,36,6.08,55
1783910048,RCS501,23,36,6.08,59
1783910048,RCS502,12,37,6.08,49
1783910048,RCS503,25,29,6.08,54
1783910048,RCS052,23,35,6.08,58
1783910048,RCS551,43,43,6.08,86
1783910048,RCS552,31,34,6.08,65
1783910048,RCS553,48,48,6.08,96
1783910048,RCS554,35,33,6.08,68
1783910048,RAS601,28,45,7.33,73
1783910048,RAS602,27,44,7.33,71
1783910048,RCS601,15,36,7.33,51
1783910048,RCS602,27,44,7.33,71
1783910048,RCS603,23,41,7.33,64
1783910048,RCS061,20,39,7.33,59
1783910048,RCS651,30,38,7.33,68
1783910048,RCS652,46,43,7.33,89
1783910048,RCS653,38,40,7.33,78
1783910048,RCS654,45,43,7.33,88
1783910048,ROE072,23,42,7.5,65
1783910048,RCS071,22,36,7.5,58
1783910048,RCS078,26,36,7.5,62
1783910048,RCS701,26,44,7.5,70
1783910048,RCS702,26,26,7.5,52
1783910048,RCS751,47,41,7.5,88
1783910048,RCS752,43,41,7.5,84
1783910048,RCS753,81,0,7.5,81
1783910048,RCS754,173,0,7.5,173
1783910049,RAS101,22,48,7.96,70
1783910049,REC101,23,40,7.96,63
1783910049,RAS103,23,54,7.96,77
1783910049,REE101,20,47,7.96,67
1783910049,RAS104,19,52,7.96,71
1783910049,RAS151,44,48,7.96,92
1783910049,REE151,46,43,7.96,89
1783910049,RAS154,46,45,7.96,91
1783910049,RME152,44,43,7.96,87
1783910049,RAS203,22,56,7.29,78
1783910049,RAS201,23,39,7.29,62
1783910049,RME201,26,46,7.29,72
1783910049,RCS201,21,22,7.29,43
1783910049,RAS202,23,33,7.29,56
1783910049,RAS252,42,44,7.29,86
1783910049,RME251,42,43,7.29,85
1783910049,RCS251,42,44,7.29,86
1783910049,RCE251,48,46,7.29,94
1783910049,ROE037,20,33,7.08,53
1783910049,RAS302,20,41,7.08,61
1783910049,REC301,21,33,7.08,54
1783910049,RCS301,23,57,7.08,80
1783910049,RCS302,19,40,7.08,59
1783910049,RCS305,20,35,7.08,55
1783910049,REC351,42,46,7.08,88
1783910049,RCS351,45,46,7.08,91
1783910049,RCS352,45,44,7.08,89
1783910049,RCS355,46,46,7.08,92
1783910049,RAS401,23,41,6.92,64
1783910049,RVE401,27,50,6.92,77
1783910049,REC405,22,39,6.92,61
1783910049,RCS401,19,49,6.92,68
1783910049,RCS402,14,29,6.92,43
1783910049,RCS403,23,33,6.92,56
1783910049,RCS451,39,46,6.92,85
1783910049,RCS452,40,45,6.92,85
1783910049,RCS453,42,45,6.92,87
1783910049,RCS454,43,42,6.92,85
1783910049,RAS501,28,35,7.04,63
1783910049,RUC501,23,46,7.04,69
1783910049,RCS501,26,44,7.04,70
1783910049,RCS502,14,27,7.04,41
1783910049,RCS503,26,25,7.04,51
1783910049,RCS052,26,49,7.04,75
1783910049,RCS551,46,46,7.04,92
1783910049,RCS552,38,40,7.04,78
1783910049,RCS553,47,47,7.04,94
1783910049,RCS554,40,44,7.04,84
1783910049,RAS601,29,49,8.04,78
1783910049,RAS602,28,49,8.04,77
1783910049,RCS601,24,46,8.04,70
1783910049,RCS602,28,49,8.04,77
1783910049,RCS603,25,47,8.04,72
1783910049,RCS061,19,42,8.04,61
1783910049,RCS651,34,42,8.04,76
1783910049,RCS652,48,46,8.04,94
1783910049,RCS653,42,45,8.04,87
1783910049,RCS654,46,46,8.04,92
1783910049,ROE072,27,35,7.92,62
1783910049,RCS071,27,39,7.92,66
1783910049,RCS078,26,44,7.92,70
1783910049,RCS701,25,46,7.92,71
1783910049,RCS702,25,37,7.92,62
1783910049,RCS751,46,43,7.92,89
1783910049,RCS752,42,43,7.92,85
1783910049,RCS753,80,0,7.92,80
1783910049,RCS754,173,0,7.92,173
1783910050,RAS101,24,56,7.46,80
1783910050,REC101,26,35,7.46,61
1783910050,RAS103,23,42,7.46,65
1783910050,REE101,17,32,7.46,49
1783910050,RAS104,23,40,7.46,63
1783910050,RAS151,45,48,7.46,93
1783910050,REE151,42,41,7.46,83
1783910050,RAS154,42,38,7.46,80
1783910050,RME152,46,43,7.46,89
1783910050,RAS203,24,30,6.54,54
1783910050,RAS201,21,39,6.54,60
1783910050,RME201,20,29,6.54,49
1783910050,RCS201,19,28,6.54,47
1783910050,RAS202,19,33,6.54,52
1783910050,RAS252,44,47,6.54,91
1783910050,RME251,44,34,6.54,78
1783910050,RCS251,36,41,6.54,77
1783910050,RCE251,47,46,6.54,93
1783910050,ROE037,25,48,7.71,73
1783910050,RAS302,18,52,7.71,70
1783910050,REC301,21,43,7.71,64
1783910050,RCS301,22,44,7.71,66
1783910050,RCS302,23,45,7.71,68
1783910050,RCS305,20,47,7.71,67
1783910050,REC351,42,42,7.71,84
1783910050,RCS351,44,46,7.71,90
1783910050,RCS352,41,42,7.71,83
1783910050,RCS355,44,47,7.71,91
1783910050,RAS401,19,31,7.33,50
1783910050,RVE401,28,50,7.33,78
1783910050,REC405,22,44,7.33,66
1783910050,RCS401,20,42,7.33,62
1783910050,RCS402,18,43,7.33,61
1783910050,RCS403,25,43,7.33,68
1783910050,RCS451,40,44,7.33,84
1783910050,RCS452,42,45,7.33,87
1783910050,RCS453,45,48,7.33,93
1783910050,RCS454,42,47,7.33,89
1783910050,RAS501,28,47,7.75,75
1783910050,RUC501,24,47,7.75,71
1783910050,RCS501,25,49,7.75,74
1783910050,RCS502,12,46,7.75,58
1783910050,RCS503,26,37,7.75,63
1783910050,RCS052,27,45,7.75,72
1783910050,RCS551,46,46,7.75,92
1783910050,RCS552,32,35,7.75,67
1783910050,RCS553,47,47,7.75,94
1783910050,RCS554,47,45,7.75,92
1783910050,RAS601,29,49,7.96,78
1783910050,RAS602,30,50,7.96,80
1783910050,RCS601,16,40,7.96,56
1783910050,RCS602,28,49,7.96,77
1783910050,RCS603,27,48,7.96,75
1783910050,RCS061,20,43,7.96,63
1783910050,RCS651,30,40,7.96,70
1783910050,RCS652,48,45,7.96,93
1783910050,RCS653,46,45,7.96,91
1783910050,RCS654,45,45,7.96,90
1783910050,ROE072,27,44,8.04,71
1783910050,RCS071,23,51,8.04,74
1783910050,RCS078,26,47,8.04,73
1783910050,RCS701,23,51,8.04,74
1783910050,RCS702,25,34,8.04,59
1783910050,RCS751,45,43,8.04,88
1783910050,RCS752,42,43,8.04,85
1783910050,RCS753,81,0,8.04,81
1783910050,RCS754,175,0,8.04,175
1783910051,RAS101,22,60,8.63,82
1783910051,REC101,26,43,8.63,69
1783910051,RAS103,25,65,8.63,90
1783910051,REE101,25,48,8.63,73
1783910051,RAS104,26,52,8.63,78
1783910051,RAS151,42,44,8.63,86
1783910051,REE151,47,48,8.63,95
1783910051,RAS154,47,48,8.63,95
1783910051,RME152,46,43,8.63,89
1783910051,RAS203,28,56,8.5,84
1783910051,RAS201,15,42,8.5,57
1783910051,RME201,27,53,8.5,80
1783910051,RCS201,29,52,8.5,81
1783910051,RAS202,28,42,8.5,70
1783910051,RAS252,45,48,8.5,93
1783910051,RME251,49,42,8.5,91
1783910051,RCS251,48,41,8.5,89
1783910051,RCE251,48,45,8.5,93
1783910051,ROE037,28,48,8.71,76
1783910051,RAS302,23,47,8.71,70
1783910051,REC301,29,44,8.71,73
1783910051,RCS301,25,56,8.71,81
1783910051,RCS302,29,56,8.71,85
1783910051,RCS305,28,53,8.71,81
1783910051,REC351,49,47,8.71,96
1783910051,RCS351,44,46,8.71,90
1783910051,RCS352,46,43,8.71,89
1783910051,RCS355,44,47,8.71,91
1783910051,RAS401,27,52,8.21,79
1783910051,RVE401,30,52,8.21,82
1783910051,REC405,27,50,8.21,77
1783910051,RCS401,29,49,8.21,78
1783910051,RCS402,19,37,8.21,56
1783910051,RCS403,27,49,8.21,76
1783910051,RCS451,49,48,8.21,97
1783910051,RCS452,49,46,8.21,95
1783910051,RCS453,49,49,8.21,98
1783910051,RCS454,49,49,8.21,98
1783910051,RAS501,29,39,7.96,68
1783910051,RUC501,23,53,7.96,76
1783910051,RCS501,25,43,7.96,68
1783910051,RCS502,24,55,7.96,79
1783910051,RCS503,26,35,7.96,61
1783910051,RCS052,30,40,7.96,70
1783910051,RCS551,45,46,7.96,91
1783910051,RCS552,50,49,7.96,99
1783910051,RCS553,47,47,7.96,94
1783910051,RCS554,50,50,7.96,100
1783910051,RAS601,30,55,8.88,85
1783910051,RAS602,30,55,8.88,85
1783910051,RCS601,25,52,8.88,77
1783910051,RCS602,30,55,8.88,85
1783910051,RCS603,29,54,8.88,83
1783910051,RCS061,23,50,8.88,73
1783910051,RCS651,45,47,8.88,92
1783910051,RCS652,49,48,8.88,97
1783910051,RCS653,48,47,8.88,95
1783910051,RCS654,47,47,8.88,94
1783910051,ROE072,27,38,7.96,65
1783910051,RCS071,25,32,7.96,57
1783910051,RCS078,27,49,7.96,76
1783910051,RCS701,27,49,7.96,76
1783910051,RCS702,24,48,7.96,72
1783910051,RCS751,48,48,7.96,96
1783910051,RCS752,40,49,7.96,89
1783910051,RCS753,82,0,7.96,82
1783910051,RCS754,177,0,7.96,177
1783910052,RAS101,20,56,7.13,76
1783910052,REC101,21,37,7.13,58
1783910052,RAS103,22,45,7.13,67
1783910052,REE101,18,32,7.13,50
1783910052,RAS104,20,39,7.13,59
1783910052,RAS151,40,44,7.13,84
1783910052,REE151,42,44,7.13,86
1783910052,RAS154,42,42,7.13,84
1783910052,RME152,44,45,7.13,89
1783910052,RAS203,24,26,6.67,50
1783910052,RAS201,16,25,6.67,41
1783910052,RME201,22,44,6.67,66
1783910052,RCS201,23,29,6.67,52
1783910052,RAS202,27,38,6.67,65
1783910052,RAS252,44,47,6.67,91
1783910052,RME251,43,41,6.67,84
1783910052,RCS251,43,45,6.67,88
1783910052,RCE251,44,43,6.67,87
1783910052,ROE037,21,24,6.29,45
1783910052,RAS302,17,35,6.29,52
1783910052,REC301,17,26,6.29,43
1783910052,RCS301,22,36,6.29,58
1783910052,RCS302,21,44,6.29,65
1783910052,RCS305,23,30,6.29,53
1783910052,REC351,44,47,6.29,91
1783910052,RCS351,44,46,6.29,90
1783910052,RCS352,36,39,6.29,75
1783910052,RCS355,43,48,6.29,91
1783910052,RAS401,19,39,6.5,58
1783910052,RVE401,25,31,6.5,56
1783910052,REC405,20,49,6.5,69
1783910052,RCS401,24,49,6.5,73
1783910052,RCS402,16,24,6.5,40
1783910052,RCS403,22,31,6.5,53
1783910052,RCS451,34,40,6.5,74
1783910052,RCS452,38,40,6.5,78
1783910052,RCS453,42,45,6.5,87
1783910052,RCS454,40,35,6.5,75
1783910052,RAS501,23,30,7.25,53
1783910052,RUC501,20,48,7.25,68
1783910052,RCS501,23,51,7.25,74
1783910052,RCS502,13,39,7.25,52
1783910052,RCS503,26,24,7.25,50
1783910052,RCS052,28,45,7.25,73
1783910052,RCS551,43,43,7.25,86
1783910052,RCS552,33,37,7.25,70
1783910052,RCS553,46,46,7.25,92
1783910052,RCS554,47,44,7.25,91
1783910052,RAS601,28,46,7.96,74
1783910052,RAS602,28,46,7.96,74
1783910052,RCS601,22,41,7.96,63
1783910052,RCS602,27,45,7.96,72
1783910052,RCS603,27,45,7.96,72
1783910052,RCS061,23,42,7.96,65
1783910052,RCS651,35,42,7.96,77
1783910052,RCS652,47,45,7.96,92
1783910052,RCS653,46,45,7.96,91
1783910052,RCS654,46,45,7.96,91
1783910052,ROE072,23,35,7.42,58
1783910052,RCS071,22,35,7.42,57
1783910052,RCS078,26,43,7.42,69
1783910052,RCS701,23,47,7.42,70
1783910052,RCS702,24,26,7.42,50
1783910052,RCS751,45,48,7.42,93
1783910052,RCS752,40,44,7.42,84
1783910052,RCS753,86,0,7.42,86
1783910052,RCS754,176,0,7.42,176
1783910053,RAS101,24,48,8.25,72
1783910053,REC101,30,28,8.25,58
1783910053,RAS103,28,65,8.25,93
1783910053,REE101,22,54,8.25,76
1783910053,RAS104,24,37,8.25,61
1783910053,RAS151,45,48,8.25,93
1783910053,REE151,46,46,8.25,92
1783910053,RAS154,46,43,8.25,89
1783910053,RME152,47,46,8.25,93
1783910053,RAS203,27,49,7.88,76
1783910053,RAS201,19,56,7.88,75
1783910053,RME201,29,37,7.88,66
1783910053,RCS201,23,30,7.88,53
1783910053,RAS202,28,45,7.88,73
1783910053,RAS252,48,48,7.88,96
1783910053,RME251,44,45,7.88,89
1783910053,RCS251,44,46,7.88,90
1783910053,RCE251,42,41,7.88,83
1783910053,ROE037,30,49,8.46,79
1783910053,RAS302,27,42,8.46,69
1783910053,REC301,30,55,8.46,85
1783910053,RCS301,25,56,8.46,81
1783910053,RCS302,27,43,8.46,70
1783910053,RCS305,22,54,8.46,76
1783910053,REC351,45,46,8.46,91
1783910053,RCS351,46,46,8.46,92
1783910053,RCS352,48,47,8.46,95
1783910053,RCS355,44,47,8.46,91
1783910053,RAS401,29,51,8.33,80
1783910053,RVE401,27,47,8.33,74
1783910053,REC405,30,48,8.33,78
1783910053,RCS401,30,59,8.33,89
1783910053,RCS402,21,40,8.33,61
1783910053,RCS403,27,40,8.33,67
1783910053,RCS451,50,48,8.33,98
1783910053,RCS452,49,45,8.33,94
1783910053,RCS453,45,45,8.33,90
1783910053,RCS454,49,49,8.33,98
1783910053,RAS501,30,49,8.33,79
1783910053,RUC501,24,44,8.33,68
1783910053,RCS501,27,54,8.33,81
1783910053,RCS502,11,52,8.33,63
1783910053,RCS503,30,39,8.33,69
1783910053,RCS052,30,60,8.33,90
1783910053,RCS551,48,48,8.33,96
1783910053,RCS552,39,42,8.33,81
1783910053,RCS553,50,50,8.33,100
1783910053,RCS554,50,50,8.33,100
1783910053,RAS601,29,54,8.5,83
1783910053,RAS602,29,54,8.5,83
1783910053,RCS601,18,47,8.5,65
1783910053,RCS602,30,55,8.5,85
1783910053,RCS603,28,54,8.5,82
1783910053,RCS061,20,48,8.5,68
1783910053,RCS651,31,42,8.5,73
1783910053,RCS652,49,48,8.5,97
1783910053,RCS653,49,48,8.5,97
1783910053,RCS654,45,47,8.5,92
1783910053,ROE072,25,32,7.83,57
1783910053,RCS071,22,31,7.83,53
1783910053,RCS078,28,48,7.83,76
1783910053,RCS701,25,44,7.83,69
1783910053,RCS702,28,42,7.83,70
1783910053,RCS751,46,46,7.83,92
1783910053,RCS752,47,43,7.83,90
1783910053,RCS753,89,0,7.83,89
1783910053,RCS754,180,0,7.83,180
1783910054,RAS101,23,42,7.46,65
1783910054,REC101,28,36,7.46,64
1783910054,RAS103,24,51,7.46,75
1783910054,REE101,19,49,7.46,68
1783910054,RAS104,23,33,7.46,56
1783910054,RAS151,43,46,7.46,89
1783910054,REE151,43,39,7.46,82
1783910054,RAS154,43,40,7.46,83
1783910054,RME152,46,43,7.46,89
1783910054,RAS203,22,56,7.83,78
1783910054,RAS201,16,61,7.83,77
1783910054,RME201,25,50,7.83,75
1783910054,RCS201,28,39,7.83,67
1783910054,RAS202,20,39,7.83,59
1783910054,RAS252,38,43,7.83,81
1783910054,RME251,41,37,7.83,78
1783910054,RCS251,48,47,7.83,95
1783910054,RCE251,46,45,7.83,91
1783910054,ROE037,22,38,7.0,60
1783910054,RAS302,23,37,7.0,60
1783910054,REC301,23,24,7.0,47
1783910054,RCS301,26,41,7.0,67
1783910054,RCS302,20,47,7.0,67
1783910054,RCS305,22,28,7.0,50
1783910054,REC351,47,42,7.0,89
1783910054,RCS351,47,45,7.0,92
1783910054,RCS352,40,41,7.0,81
1783910054,RCS355,44,48,7.0,92
1783910054,RAS401,23,52,7.04,75
1783910054,RVE401,27,37,7.04,64
1783910054,REC405,18,34,7.04,52
1783910054,RCS401,17,46,7.04,63
1783910054,RCS402,21,30,7.04,51
1783910054,RCS403,21,37,7.04,58
1783910054,RCS451,37,43,7.04,80
1783910054,RCS452,37,48,7.04,85
1783910054,RCS453,41,42,7.04,83
1783910054,RCS454,38,35,7.04,73
1783910054,RAS501,28,52,8.08,80
1783910054,RUC501,22,55,8.08,77
1783910054,RCS501,25,51,8.08,76
1783910054,RCS502,18,45,8.08,63
1783910054,RCS503,25,38,8.08,63
1783910054,RCS052,29,47,8.08,76
1783910054,RCS551,45,45,8.08,90
1783910054,RCS552,36,42,8.08,78
1783910054,RCS553,49,49,8.08,98
1783910054,RCS554,47,46,8.08,93
1783910054,RAS601,28,50,8.29,78
1783910054,RAS602,28,50,8.29,78
1783910054,RCS601,24,47,8.29,71
1783910054,RCS602,28,50,8.29,78
1783910054,RCS603,28,50,8.29,78
1783910054,RCS061,24,47,8.29,71
1783910054,RCS651,40,43,8.29,83
1783910054,RCS652,47,45,8.29,92
1783910054,RCS653,48,45,8.29,93
1783910054,RCS654,49,46,8.29,95
1783910054,ROE072,26,34,7.96,60
1783910054,RCS071,25,36,7.96,61
1783910054,RCS078,27,48,7.96,75
1783910054,RCS701,25,43,7.96,68
1783910054,RCS702,29,50,7.96,79
1783910054,RCS751,46,48,7.96,94
1783910054,RCS752,48,47,7.96,95
1783910054,RCS753,88,0,7.96,88
1783910054,RCS754,176,0,7.96,176
1783910056,RAS101,21,45,7.21,66
1783910056,REC101,26,30,7.21,56
1783910056,RAS103,24,51,7.21,75
1783910056,REE101,22,43,7.21,65
1783910056,RAS104,20,29,7.21,49
1783910056,RAS151,41,42,7.21,83
1783910056,REE151,46,40,7.21,86
1783910056,RAS154,46,45,7.21,91
1783910056,RME152,45,41,7.21,86
1783910056,RAS203,24,42,6.54,66
1783910056,RAS201,19,31,6.54,50
1783910056,RME201,19,37,6.54,56
1783910056,RCS201,23,35,6.54,58
1783910056,RAS202,18,36,6.54,54
1783910056,RAS252,35,38,6.54,73
1783910056,RME251,35,39,6.54,74
1783910056,RCS251,44,45,6.54,89
1783910056,RCE251,30,30,6.54,60
1783910056,ROE037,19,45,6.88,64
1783910056,RAS302,17,37,6.88,54
1783910056,REC301,27,35,6.88,62
1783910056,RCS301,21,32,6.88,53
1783910056,RCS302,17,38,6.88,55
1783910056,RCS305,21,34,6.88,55
1783910056,REC351,39,46,6.88,85
1783910056,RCS351,45,46,6.88,91
1783910056,RCS352,42,43,6.88,85
1783910056,RCS355,45,47,6.88,92
1783910056,RAS401,19,47,6.79,66
1783910056,RVE401,28,38,6.79,66
1783910056,REC405,14,39,6.79,53
1783910056,RCS401,24,51,6.79,75
1783910056,RCS402,22,34,6.79,56
1783910056,RCS403,23,21,6.79,44
1783910056,RCS451,44,46,6.79,90
1783910056,RCS452,45,41,6.79,86
1783910056,RCS453,48,40,6.79,88
1783910056,RCS454,45,48,6.79,93
1783910056,RAS501,28,34,7.29,62
1783910056,RUC501,23,41,7.29,64
1783910056,RCS501,23,52,7.29,75
1783910056,RCS502,9,45,7.29,54
1783910056,RCS503,25,27,7.29,52
1783910056,RCS052,26,49,7.29,75
1783910056,RCS551,43,43,7.29,86
1783910056,RCS552,30,35,7.29,65
1783910056,RCS553,47,47,7.29,94
1783910056,RCS554,44,41,7.29,85
1783910056,RAS601,26,45,7.88,71
1783910056,RAS602,26,45,7.88,71
1783910056,RCS601,17,39,7.88,56
1783910056,RCS602,28,47,7.88,75
1783910056,RCS603,26,45,7.88,71
1783910056,RCS061,21,42,7.88,63
1783910056,RCS651,40,42,7.88,82
1783910056,RCS652,47,44,7.88,91
1783910056,RCS653,47,44,7.88,91
1783910056,RCS654,46,44,7.88,90
1783910056,ROE072,23,39,7.79,62
1783910056,RCS071,25,35,7.79,60
1783910056,RCS078,26,40,7.79,66
1783910056,RCS701,25,46,7.79,71
1783910056,RCS702,22,44,7.79,66
1783910056,RCS751,46,44,7.79,90
1783910056,RCS752,37,43,7.79,80
1783910056,RCS753,83,0,7.79,83
1783910056,RCS754,173,0,7.79,173
1783910057,RAS101,19,53,8.0,72
1783910057,REC101,27,31,8.0,58
1783910057,RAS103,29,68,8.0,97
1783910057,REE101,21,51,8.0,72
1783910057,RAS104,22,34,8.0,56
1783910057,RAS151,39,42,8.0,81
1783910057,REE151,45,46,8.0,91
1783910057,RAS154,45,42,8.0,87
1783910057,RME152,44,44,8.0,88
1783910057,RAS203,28,49,7.88,77
1783910057,RAS201,18,49,7.88,67
1783910057,RME201,27,55,7.88,82
1783910057,RCS201,22,34,7.88,56
1783910057,RAS202,23,44,7.88,67
1783910057,RAS252,40,42,7.88,82
1783910057,RME251,44,40,7.88,84
1783910057,RCS251,42,43,7.88,85
1783910057,RCE251,46,45,7.88,91
1783910057,ROE037,25,47,8.04,72
1783910057,RAS302,23,37,8.04,60
1783910057,REC301,30,50,8.04,80
1783910057,RCS301,23,64,8.04,87
1783910057,RCS302,28,27,8.04,55
1783910057,RCS305,24,44,8.04,68
1783910057,REC351,49,49,8.04,98
1783910057,RCS351,45,46,8.04,91
1783910057,RCS352,46,45,8.04,91
1783910057,RCS355,46,48,8.04,94
1783910057,RAS401,23,45,7.63,68
1783910057,RVE401,30,41,7.63,71
1783910057,REC405,27,52,7.63,79
1783910057,RCS401,24,45,7.63,69
1783910057,RCS402,16,43,7.63,59
1783910057,RCS403,26,43,7.63,69
1783910057,RCS451,44,47,7.63,91
1783910057,RCS452,46,45,7.63,91
1783910057,RCS453,49,49,7.63,98
1783910057,RCS454,46,48,7.63,94
1783910057,RAS501,28,43,7.21,71
1783910057,RUC501,19,39,7.21,58
1783910057,RCS501,26,43,7.21,69
1783910057,RCS502,13,42,7.21,55
1783910057,RCS503,28,34,7.21,62
1783910057,RCS052,26,43,7.21,69
1783910057,RCS551,46,46,7.21,92
1783910057,RCS552,34,38,7.21,72
1783910057,RCS553,48,48,7.21,96
1783910057,RCS554,44,42,7.21,86
1783910057,RAS601,26,50,8.25,76
1783910057,RAS602,26,50,8.25,76
1783910057,RCS601,21,47,8.25,68
1783910057,RCS602,29,52,8.25,81
1783910057,RCS603,28,52,8.25,80
1783910057,RCS061,21,47,8.25,68
1783910057,RCS651,32,42,8.25,74
1783910057,RCS652,48,46,8.25,94
1783910057,RCS653,47,46,8.25,93
1783910057,RCS654,47,46,8.25,93
1783910057,ROE072,27,26,7.38,53
1783910057,RCS071,24,38,7.38,62
1783910057,RCS078,27,42,7.38,69
1783910057,RCS701,25,44,7.38,69
1783910057,RCS702,24,30,7.38,54
1783910057,RCS751,46,46,7.38,92
1783910057,RCS752,40,47,7.38,87
1783910057,RCS753,84,0,7.38,84
1783910057,RCS754,174,0,7.38,174
1783910058,RAS101,19,34,6.79,53
1783910058,REC101,24,35,6.79,59
1783910058,RAS103,19,49,6.79,68
1783910058,REE101,17,37,6.79,54
1783910058,RAS104,23,35,6.79,58
1783910058,RAS151,39,41,6.79,80
1783910058,REE151,43,40,6.79,83
1783910058,RAS154,43,41,6.79,84
1783910058,RME152,44,45,6.79,89
1783910058,RAS203,21,38,6.88,59
1783910058,RAS201,17,53,6.88,70
1783910058,RME201,19,33,6.88,52
1783910058,RCS201,27,37,6.88,64
1783910058,RAS202,15,37,6.88,52
1783910058,RAS252,38,42,6.88,80
1783910058,RME251,30,37,6.88,67
1783910058,RCS251,47,48,6.88,95
1783910058,RCE251,30,30,6.88,60
1783910058,ROE037,18,41,7.29,59
1783910058,RAS302,20,37,7.29,57
1783910058,REC301,26,32,7.29,58
1783910058,RCS301,29,50,7.29,79
1783910058,RCS302,23,30,7.29,53
1783910058,RCS305,30,59,7.29,89
1783910058,REC351,43,42,7.29,85
1783910058,RCS351,45,48,7.29,93
1783910058,RCS352,37,39,7.29,76
1783910058,RCS355,45,47,7.29,92
1783910058,RAS401,21,33,5.21,54
1783910058,RVE401,23,38,5.21,61
1783910058,REC405,27,25,5.21,52
1783910058,RCS401,12,42,5.21,54
1783910058,RCS402,2,38,5.21,40
1783910058,RCS403,7,29,5.21,36
1783910058,RCS451,32,46,5.21,78
1783910058,RCS452,33,45,5.21,78
1783910058,RCS453,30,35,5.21,65
1783910058,RCS454,34,47,5.21,81
1783910058,RAS501,22,35,6.46,57
1783910058,RUC501,19,41,6.46,60
1783910058,RCS501,24,41,6.46,65
1783910058,RCS502,16,27,6.46,43
1783910058,RCS503,26,22,6.46,48
1783910058,RCS052,23,46,6.46,69
1783910058,RCS551,44,44,6.46,88
1783910058,RCS552,43,46,6.46,89
1783910058,RCS553,46,46,6.46,92
1783910058,RCS554,36,42,6.46,78
1783910058,RAS601,25,45,7.21,70
1783910058,RAS602,26,45,7.21,71
1783910058,RCS601,12,35,7.21,47
1783910058,RCS602,23,43,7.21,66
1783910058,RCS603,21,42,7.21,63
1783910058,RCS061,21,42,7.21,63
1783910058,RCS651,30,39,7.21,69
1783910058,RCS652,36,41,7.21,77
1783910058,RCS653,42,43,7.21,85
1783910058,RCS654,45,44,7.21,89
1783910058,ROE072,27,36,7.67,63
1783910058,RCS071,19,49,7.67,68
1783910058,RCS078,24,39,7.67,63
1783910058,RCS701,27,46,7.67,73
1783910058,RCS702,22,32,7.67,54
1783910058,RCS751,48,44,7.67,92
1783910058,RCS752,37,43,7.67,80
1783910058,RCS753,82,0,7.67,82
1783910058,RCS754,171,0,7.67,171
1783910059,RAS101,23,26,7.29,49
1783910059,REC101,27,50,7.29,77
1783910059,RAS103,25,45,7.29,70
1783910059,REE101,19,48,7.29,67
1783910059,RAS104,24,32,7.29,56
1783910059,RAS151,43,44,7.29,87
1783910059,REE151,43,38,7.29,81
1783910059,RAS154,43,44,7.29,87
1783910059,RME152,45,42,7.29,87
1783910059,RAS203,18,42,6.92,60
1783910059,RAS201,15,46,6.92,61
1783910059,RME201,20,35,6.92,55
1783910059,RCS201,19,31,6.92,50
1783910059,RAS202,23,38,6.92,61
1783910059,RAS252,44,47,6.92,91
1783910059,RME251,38,41,6.92,79
1783910059,RCS251,38,41,6.92,79
1783910059,RCE251,33,34,6.92,67
1783910059,ROE037,20,39,6.54,59
1783910059,RAS302,17,47,6.54,64
1783910059,REC301,17,40,6.54,57
1783910059,RCS301,19,40,6.54,59
1783910059,RCS302,19,21,6.54,40
1783910059,RCS305,19,46,6.54,65
1783910059,REC351,42,45,6.54,87
1783910059,RCS351,43,46,6.54,89
1783910059,RCS352,34,37,6.54,71
1783910059,RCS355,46,47,6.54,93
1783910059,RAS401,21,47,6.33,68
1783910059,RVE401,24,41,6.33,65
1783910059,REC405,19,22,6.33,41
1783910059,RCS401,19,31,6.33,50
1783910059,RCS402,13,35,6.33,48
1783910059,RCS403,19,40,6.33,59
1783910059,RCS451,39,38,6.33,77
1783910059,RCS452,43,42,6.33,85
1783910059,RCS453,40,41,6.33,81
1783910059,RCS454,42,35,6.33,77
1783910059,RAS501,25,35,6.54,60
1783910059,RUC501,22,41,6.54,63
1783910059,RCS501,25,34,6.54,59
1783910059,RCS502,12,34,6.54,46
1783910059,RCS503,26,26,6.54,52
1783910059,RCS052,23,33,6.54,56
1783910059,RCS551,45,45,6.54,90
1783910059,RCS552,32,37,6.54,69
1783910059,RCS553,46,46,6.54,92
1783910059,RCS554,37,40,6.54,77
1783910059,RAS601,27,46,7.54,73
1783910059,RAS602,28,47,7.54,75
1783910059,RCS601,18,40,7.54,58
1783910059,RCS602,27,46,7.54,73
1783910059,RCS603,26,45,7.54,71
1783910059,RCS061,19,40,7.54,59
1783910059,RCS651,33,39,7.54,72
1783910059,RCS652,46,43,7.54,89
1783910059,RCS653,42,42,7.54,84
1783910059,RCS654,45,43,7.54,88
1783910059,ROE072,23,41,7.33,64
1783910059,RCS071,27,33,7.33,60
1783910059,RCS078,24,41,7.33,65
1783910059,RCS701,23,41,7.33,64
1783910059,RCS702,26,32,7.33,58
1783910059,RCS751,45,47,7.33,92
1783910059,RCS752,43,47,7.33,90
1783910059,RCS753,75,0,7.33,75
1783910059,RCS754,159,0,7.33,159
1783910061,RAS101,25,38,6.96,63
1783910061,REC101,25,24,6.96,49
1783910061,RAS103,22,43,6.96,65
1783910061,REE101,20,47,6.96,67
1783910061,RAS104,23,30,6.96,53
1783910061,RAS151,41,44,6.96,85
1783910061,REE151,47,38,6.96,85
1783910061,RAS154,47,38,6.96,85
1783910061,RME152,44,42,6.96,86
1783910061,RAS203,14,49,6.08,63
1783910061,RAS201,15,42,6.08,57
1783910061,RME201,20,21,6.08,41
1783910061,RCS201,19,21,6.08,40
1783910061,RAS202,21,30,6.08,51
1783910061,RAS252,40,44,6.08,84
1783910061,RME251,42,39,6.08,81
1783910061,RCS251,36,41,6.08,77
1783910061,RCE251,39,40,6.08,79
1783910061,ROE037,15,43,6.25,58
1783910061,RAS302,17,35,6.25,52
1783910061,REC301,18,32,6.25,50
1783910061,RCS301,19,49,6.25,68
1783910061,RCS302,18,23,6.25,41
1783910061,RCS305,19,30,6.25,49
1783910061,REC351,40,41,6.25,81
1783910061,RCS351,44,46,6.25,90
1783910061,RCS352,35,38,6.25,73
1783910061,RCS355,44,47,6.25,91
1783910061,RAS401,23,25,5.88,48
1783910061,RVE401,27,38,5.88,65
1783910061,REC405,20,24,5.88,44
1783910061,RCS401,16,26,5.88,42
1783910061,RCS402,16,35,5.88,51
1783910061,RCS403,16,35,5.88,51
1783910061,RCS451,36,40,5.88,76
1783910061,RCS452,36,41,5.88,77
1783910061,RCS453,39,43,5.88,82
1783910061,RCS454,39,48,5.88,87
1783910061,RAS501,25,27,6.5,52
1783910061,RUC501,22,44,6.5,66
1783910061,RCS501,23,33,6.5,56
1783910061,RCS502,13,31,6.5,44
1783910061,RCS503,26,41,6.5,67
1783910061,RCS052,24,39,6.5,63
1783910061,RCS551,43,44,6.5,87
1783910061,RCS552,30,30,6.5,60
1783910061,RCS553,46,46,6.5,92
1783910061,RCS554,40,37,6.5,77
1783910061,RAS601,28,45,7.92,73
1783910061,RAS602,28,45,7.92,73
1783910061,RCS601,22,40,7.92,62
1783910061,RCS602,29,45,7.92,74
1783910061,RCS603,28,45,7.92,73
1783910061,RCS061,22,40,7.92,62
1783910061,RCS651,39,41,7.92,80
1783910061,RCS652,48,43,7.92,91
1783910061,RCS653,46,43,7.92,89
1783910061,RCS654,45,43,7.92,88
1783910061,ROE072,23,40,7.63,63
1783910061,RCS071,26,35,7.63,61
1783910061,RCS078,27,44,7.63,71
1783910061,RCS701,25,46,7.63,71
1783910061,RCS702,26,21,7.63,47
1783910061,RCS751,46,45,7.63,91
1783910061,RCS752,43,44,7.63,87
1783910061,RCS753,78,0,7.63,78
1783910061,RCS754,171,0,7.63,171
1883910901,ROE037,22,40,7.0,62
1883910901,RAS302,18,35,7.0,53
1883910901,REC301,17,35,7.0,52
1883910901,RCS301,20,44,7.0,64
1883910901,RCS302,16,52,7.0,68
1883910901,RCS305,20,43,7.0,63
1883910901,REC351,38,40,7.0,78
1883910901,RCS351,40,44,7.0,84
1883910901,RCS352,37,38,7.0,75
1883910901,RCS355,41,45,7.0,86
1883910901,RAS401,19,50,6.88,69
1883910901,RVE401,26,33,6.88,59
1883910901,REC405,17,34,6.88,51
1883910901,RCS401,20,30,6.88,50
1883910901,RCS402,17,34,6.88,51
1883910901,RCS403,23,45,6.88,68
1883910901,RCS451,40,41,6.88,81
1883910901,RCS452,43,43,6.88,86
1883910901,RCS453,47,48,6.88,95
1883910901,RCS454,43,45,6.88,88
1883910901,RAS501,25,50,7.46,75
1883910901,RUC501,23,58,7.46,81
1883910901,RCS501,22,44,7.46,66
1883910901,RCS502,8,35,7.46,43
1883910901,RCS503,29,48,7.46,77
1883910901,RCS052,27,44,7.46,71
1883910901,RCS551,42,42,7.46,84
1883910901,RCS552,30,33,7.46,63
1883910901,RCS553,47,47,7.46,94
1883910901,RCS554,45,43,7.46,88
1883910901,RAS601,28,49,7.71,77
1883910901,RAS602,28,49,7.71,77
1883910901,RCS601,16,40,7.71,56
1883910901,RCS602,29,49,7.71,78
1883910901,RCS603,26,47,7.71,73
1883910901,RCS061,19,42,7.71,61
1883910901,RCS651,30,39,7.71,69
1883910901,RCS652,48,44,7.71,92
1883910901,RCS653,44,43,7.71,87
1883910901,RCS654,45,44,7.71,89
1883910901,ROE072,26,40,7.58,66
1883910901,RCS071,24,42,7.58,66
1883910901,RCS078,27,38,7.58,65
1883910901,RCS701,27,50,7.58,77
1883910901,RCS702,22,30,7.58,52
1883910901,RCS751,48,44,7.58,92
1883910901,RCS752,37,43,7.58,80
1883910901,RCS753,73,0,7.58,73
1883910901,RCS754,172,0,7.58,172
1883910902,ROE037,22,24,6.13,46
1883910902,RAS302,17,33,6.13,50
1883910902,REC301,20,27,6.13,47
1883910902,RCS301,18,26,6.13,44
1883910902,RCS302,17,67,6.13,84
1883910902,RCS305,20,27,6.13,47
1883910902,REC351,38,44,6.13,82
1883910902,RCS351,41,48,6.13,89
1883910902,RCS352,35,39,6.13,74
1883910902,RCS355,41,44,6.13,85
1883910902,RAS401,19,27,6.21,46
1883910902,RVE401,27,39,6.21,66
1883910902,REC405,18,28,6.21,46
1883910902,RCS401,20,26,6.21,46
1883910902,RCS402,16,43,6.21,59
1883910902,RCS403,19,36,6.21,55
1883910902,RCS451,40,42,6.21,82
1883910902,RCS452,41,40,6.21,81
1883910902,RCS453,40,42,6.21,82
1883910902,RCS454,40,47,6.21,87
1883910902,RAS501,25,43,6.79,68
1883910902,RUC501,20,29,6.79,49
1883910902,RCS501,22,44,6.79,66
1883910902,RCS502,10,32,6.79,42
1883910902,RCS503,26,46,6.79,72
1883910902,RCS052,23,53,6.79,76
1883910902,RCS551,42,42,6.79,84
1883910902,RCS552,30,35,6.79,65
1883910902,RCS553,47,47,6.79,94
1883910902,RCS554,36,38,6.79,74
1883910902,RAS601,28,46,7.71,74
1883910902,RAS602,27,45,7.71,72
1883910902,RCS601,22,41,7.71,63
1883910902,RCS602,28,46,7.71,74
1883910902,RCS603,28,46,7.71,74
1883910902,RCS061,19,39,7.71,58
1883910902,RCS651,36,41,7.71,77
1883910902,RCS652,47,44,7.71,91
1883910902,RCS653,45,44,7.71,89
1883910902,RCS654,45,44,7.71,89
1883910902,ROE072,24,39,7.54,63
1883910902,RCS071,25,35,7.54,60
1883910902,RCS078,26,45,7.54,71
1883910902,RCS701,25,43,7.54,68
1883910902,RCS702,24,32,7.54,56
1883910902,RCS751,46,43,7.54,89
1883910902,RCS752,40,44,7.54,84
1883910902,RCS753,74,0,7.54,74
1883910902,RCS754,169,0,7.54,169
1883910903,RAS501,25,47,7.75,72
1883910903,RUC501,22,52,7.75,74
1883910903,RCS501,24,50,7.75,74
1883910903,RCS502,12,50,7.75,62
1883910903,RCS503,27,52,7.75,79
1883910903,RCS052,25,36,7.75,61
1883910903,RCS551,44,44,7.75,88
1883910903,RCS552,30,33,7.75,63
1883910903,RCS553,47,47,7.75,94
1883910903,RCS554,42,36,7.75,78
1883910903,RAS601,30,46,7.54,76
1883910903,RAS602,30,46,7.54,76
1883910903,RCS601,17,37,7.54,54
1883910903,RCS602,30,46,7.54,76
1883910903,RCS603,27,44,7.54,71
1883910903,RCS061,17,37,7.54,54
1883910903,RCS651,30,38,7.54,68
1883910903,RCS652,49,44,7.54,93
1883910903,RCS653,46,43,7.54,89
1883910903,RCS654,46,43,7.54,89
1883910903,ROE037,19,41,6.58,60
1883910903,RAS302,12,48,6.58,60
1883910903,REC301,12,41,6.58,53
1883910903,RCS301,9,41,6.58,50
1883910903,RCS302,11,42,6.58,53
1883910903,RCS305,19,26,6.58,45
1883910903,REC351,38,42,6.58,80
1883910903,RCS351,41,44,6.58,85
1883910903,RCS352,35,38,6.58,73
1883910903,RCS355,41,45,6.58,86
1883910903,RAS401,13,24,5.17,37
1883910903,RVE401,24,25,5.17,49
1883910903,REC405,18,32,5.17,50
1883910903,RCS401,17,31,5.17,48
1883910903,RCS402,15,36,5.17,51
1883910903,RCS403,20,32,5.17,52
1883910903,RCS451,37,41,5.17,78
1883910903,RCS452,38,41,5.17,79
1883910903,RCS453,40,41,5.17,81
1883910903,RCS454,43,43,5.17,86
1883910903,ROE072,28,55,8.08,83
1883910903,RCS071,25,35,8.08,60
1883910903,RCS078,28,51,8.08,79
1883910903,RCS701,24,49,8.08,73
1883910903,RCS702,28,27,8.08,55
1883910903,RCS751,45,44,8.08,89
1883910903,RCS752,47,44,8.08,91
1883910903,RCS753,86,0,8.08,86
1883910903,RCS754,174,0,8.08,174
1883910904,ROE037,22,35,6.17,57
1883910904,RAS302,17,32,6.17,49
1883910904,REC301,22,33,6.17,55
1883910904,RCS301,12,31,6.17,43
1883910904,RCS302,19,30,6.17,49
1883910904,RCS305,19,46,6.17,65
1883910904,REC351,41,47,6.17,88
1883910904,RCS351,41,45,6.17,86
1883910904,RCS352,39,42,6.17,81
1883910904,RCS355,42,45,6.17,87
1883910904,RAS401,26,41,6.79,67
1883910904,RVE401,27,39,6.79,66
1883910904,REC405,26,34,6.79,60
1883910904,RCS401,22,35,6.79,57
1883910904,RCS402,14,42,6.79,56
1883910904,RCS403,16,29,6.79,45
1883910904,RCS451,42,40,6.79,82
1883910904,RCS452,44,40,6.79,84
1883910904,RCS453,40,42,6.79,82
1883910904,RCS454,45,48,6.79,93
1883910904,RAS501,30,40,6.83,70
1883910904,RUC501,22,35,6.83,57
1883910904,RCS501,26,37,6.83,63
1883910904,RCS502,10,30,6.83,40
1883910904,RCS503,29,39,6.83,68
1883910904,RCS052,24,42,6.83,66
1883910904,RCS551,46,46,6.83,92
1883910904,RCS552,31,35,6.83,66
1883910904,RCS553,49,49,6.83,98
1883910904,RCS554,45,40,6.83,85
1883910904,RAS601,30,47,7.67,77
1883910904,RAS602,30,47,7.67,77
1883910904,RCS601,17,38,7.67,55
1883910904,RCS602,27,45,7.67,72
1883910904,RCS603,27,45,7.67,72
1883910904,RCS061,19,39,7.67,58
1883910904,RCS651,35,42,7.67,77
1883910904,RCS652,48,45,7.67,93
1883910904,RCS653,47,45,7.67,92
1883910904,RCS654,45,45,7.67,90
1883910904,ROE072,29,36,7.63,65
1883910904,RCS071,24,31,7.63,55
1883910904,RCS078,27,45,7.63,72
1883910904,RCS701,22,41,7.63,63
1883910904,RCS702,26,39,7.63,65
1883910904,RCS751,45,44,7.63,89
1883910904,RCS752,43,43,7.63,86
1883910904,RCS753,80,0,7.63,80
1883910904,RCS754,171,0,7.63,171
1883910905,ROE037,25,34,7.17,59
1883910905,RAS302,23,56,7.17,79
1883910905,REC301,21,48,7.17,69
1883910905,RCS301,23,37,7.17,60
1883910905,RCS302,23,33,7.17,56
1883910905,RCS305,20,49,7.17,69
1883910905,REC351,40,47,7.17,87
1883910905,RCS351,41,45,7.17,86
1883910905,RCS352,41,43,7.17,84
1883910905,RCS355,43,43,7.17,86
1883910905,RAS401,25,37,7.46,62
1883910905,RVE401,28,39,7.46,67
1883910905,REC405,23,50,7.46,73
1883910905,RCS401,24,55,7.46,79
1883910905,RCS402,22,46,7.46,68
1883910905,RCS403,23,33,7.46,56
1883910905,RCS451,44,41,7.46,85
1883910905,RCS452,46,43,7.46,89
1883910905,RCS453,42,45,7.46,87
1883910905,RCS454,47,49,7.46,96
1883910905,RAS501,28,48,7.75,76
1883910905,RUC501,23,46,7.75,69
1883910905,RCS501,27,45,7.75,72
1883910905,RCS502,10,45,7.75,55
1883910905,RCS503,30,47,7.75,77
1883910905,RCS052,29,42,7.75,71
1883910905,RCS551,47,47,7.75,94
1883910905,RCS552,31,35,7.75,66
1883910905,RCS553,50,49,7.75,99
1883910905,RCS554,47,47,7.75,94
1883910905,RAS601,30,52,8.38,82
1883910905,RAS602,30,52,8.38,82
1883910905,RCS601,21,46,8.38,67
1883910905,RCS602,30,52,8.38,82
1883910905,RCS603,27,50,8.38,77
1883910905,RCS061,18,44,8.38,62
1883910905,RCS651,35,43,8.38,78
1883910905,RCS652,50,47,8.38,97
1883910905,RCS653,49,47,8.38,96
1883910905,RCS654,46,46,8.38,92
1883910905,ROE072,29,44,8.54,73
1883910905,RCS071,25,46,8.54,71
1883910905,RCS078,28,55,8.54,83
1883910905,RCS701,24,53,8.54,77
1883910905,RCS702,28,48,8.54,76
1883910905,RCS751,45,49,8.54,94
1883910905,RCS752,47,44,8.54,91
1883910905,RCS753,82,0,8.54,82
1883910905,RCS754,177,0,8.54,177
1883910906,ROE037,18,22,3.83,40
1883910906,RAS302,14,21,3.83,35
1883910906,REC301,18,20,3.83,38
1883910906,RCS301,9,28,3.83,37
1883910906,RCS302,17,49,3.83,66
1883910906,RCS305,26,23,3.83,49
1883910906,REC351,37,47,3.83,84
1883910906,RCS351,39,46,3.83,85
1883910906,RCS352,34,36,3.83,70
1883910906,RCS355,43,44,3.83,87
1883910906,RAS401,16,12,3.38,28
1883910906,RVE401,25,24,3.38,49
1883910906,REC405,14,24,3.38,38
1883910906,RCS401,19,29,3.38,48
1883910906,RCS402,14,32,3.38,46
1883910906,RCS403,7,22,3.38,29
1883910906,RCS451,39,42,3.38,81
1883910906,RCS452,41,40,3.38,81
1883910906,RCS453,35,48,3.38,83
1883910906,RCS454,40,48,3.38,88
1883910907,ROE037,18,27,6.33,45
1883910907,RAS302,14,38,6.33,52
1883910907,REC301,15,35,6.33,50
1883910907,RCS301,11,29,6.33,40
1883910907,RCS302,16,37,6.33,53
1883910907,RCS305,23,49,6.33,72
1883910907,REC351,38,43,6.33,81
1883910907,RCS351,40,45,6.33,85
1883910907,RCS352,34,35,6.33,69
1883910907,RCS355,42,44,6.33,86
1883910907,RAS401,18,33,5.83,51
1883910907,RVE401,24,30,5.83,54
1883910907,REC405,16,37,5.83,53
1883910907,RCS401,16,28,5.83,44
1883910907,RCS402,12,36,5.83,48
1883910907,RCS403,14,32,5.83,46
1883910907,RCS451,36,41,5.83,77
1883910907,RCS452,38,40,5.83,78
1883910907,RCS453,39,41,5.83,80
1883910907,RCS454,35,40,5.83,75
1883910907,RAS501,25,41,6.54,66
1883910907,RUC501,19,41,6.54,60
1883910907,RCS501,25,31,6.54,56
1883910907,RCS502,8,37,6.54,45
1883910907,RCS503,25,32,6.54,57
1883910907,RCS052,23,28,6.54,51
1883910907,RCS551,45,45,6.54,90
1883910907,RCS552,30,33,6.54,63
1883910907,RCS553,47,47,6.54,94
1883910907,RCS554,35,39,6.54,74
1883910907,RAS601,28,44,7.5,72
1883910907,RAS602,26,42,7.5,68
1883910907,RCS601,18,37,7.5,55
1883910907,RCS602,28,44,7.5,72
1883910907,RCS603,24,41,7.5,65
1883910907,RCS061,21,39,7.5,60
1883910907,RCS651,35,40,7.5,75
1883910907,RCS652,48,43,7.5,91
1883910907,RCS653,44,42,7.5,86
1883910907,RCS654,46,43,7.5,89
1883910907,ROE072,24,34,7.71,58
1883910907,RCS071,28,52,7.71,80
1883910907,RCS078,27,38,7.71,65
1883910907,RCS701,24,39,7.71,63
1883910907,RCS702,24,41,7.71,65
1883910907,RCS751,45,44,7.71,89
1883910907,RCS752,40,43,7.71,83
1883910907,RCS753,81,0,7.71,81
1883910907,RCS754,172,0,7.71,172
1883910908,ROE037,19,36,6.96,55
1883910908,RAS302,17,42,6.96,59
1883910908,REC301,20,36,6.96,56
1883910908,RCS301,25,64,6.96,89
1883910908,RCS302,14,27,6.96,41
1883910908,RCS305,26,46,6.96,72
1883910908,REC351,42,46,6.96,88
1883910908,RCS351,40,45,6.96,85
1883910908,RCS352,42,44,6.96,86
1883910908,RCS355,41,43,6.96,84
1883910908,RAS401,23,38,6.71,61
1883910908,RVE401,26,34,6.71,60
1883910908,REC405,20,33,6.71,53
1883910908,RCS401,22,37,6.71,59
1883910908,RCS402,15,31,6.71,46
1883910908,RCS403,23,31,6.71,54
1883910908,RCS451,42,40,6.71,82
1883910908,RCS452,42,45,6.71,87
1883910908,RCS453,46,47,6.71,93
1883910908,RCS454,41,47,6.71,88
1883910908,RAS501,27,42,7.17,69
1883910908,RUC501,20,37,7.17,57
1883910908,RCS501,27,34,7.17,61
1883910908,RCS502,16,42,7.17,58
1883910908,RCS503,26,49,7.17,75
1883910908,RCS052,24,39,7.17,63
1883910908,RCS551,47,47,7.17,94
1883910908,RCS552,36,42,7.17,78
1883910908,RCS553,47,47,7.17,94
1883910908,RCS554,36,40,7.17,76
1883910908,RAS601,28,47,8.0,75
1883910908,RAS602,28,47,8.0,75
1883910908,RCS601,20,41,8.0,61
1883910908,RCS602,28,47,8.0,75
1883910908,RCS603,25,45,8.0,70
1883910908,RCS061,20,41,8.0,61
1883910908,RCS651,37,43,8.0,80
1883910908,RCS652,47,46,8.0,93
1883910908,RCS653,46,46,8.0,92
1883910908,RCS654,46,46,8.0,92
1883910908,ROE072,26,41,7.83,67
1883910908,RCS071,22,38,7.83,60
1883910908,RCS078,26,49,7.83,75
1883910908,RCS701,27,50,7.83,77
1883910908,RCS702,24,29,7.83,53
1883910908,RCS751,47,47,7.83,94
1883910908,RCS752,40,47,7.83,87
1883910908,RCS753,82,0,7.83,82
1883910908,RCS754,171,0,7.83,171
1883910909,ROE037,21,50,6.46,71
1883910909,RAS302,17,42,6.46,59
1883910909,REC301,15,29,6.46,44
1883910909,RCS301,16,42,6.46,58
1883910909,RCS302,17,44,6.46,61
1883910909,RCS305,19,26,6.46,45
1883910909,REC351,41,37,6.46,78
1883910909,RCS351,40,45,6.46,85
1883910909,RCS352,37,40,6.46,77
1883910909,RCS355,41,45,6.46,86
1883910909,RAS401,12,21,5.71,33
1883910909,RVE401,28,41,5.71,69
1883910909,REC405,15,42,5.71,57
1883910909,RCS401,13,46,5.71,59
1883910909,RCS402,16,34,5.71,50
1883910909,RCS403,18,44,5.71,62
1883910909,RCS451,35,42,5.71,77
1883910909,RCS452,37,40,5.71,77
1883910909,RCS453,47,47,5.71,94
1883910909,RCS454,37,35,5.71,72
1883910909,RAS501,28,43,6.83,71
1883910909,RUC501,23,47,6.83,70
1883910909,RCS501,25,41,6.83,66
1883910909,RCS502,8,24,6.83,32
1883910909,RCS503,25,54,6.83,79
1883910909,RCS052,26,58,6.83,84
1883910909,RCS551,45,45,6.83,90
1883910909,RCS552,30,38,6.83,68
1883910909,RCS553,48,48,6.83,96
1883910909,RCS554,38,40,6.83,78
1883910909,RAS601,28,47,7.63,75
1883910909,RAS602,28,47,7.63,75
1883910909,RCS601,17,39,7.63,56
1883910909,RCS602,28,47,7.63,75
1883910909,RCS603,23,43,7.63,66
1883910909,RCS061,20,41,7.63,61
1883910909,RCS651,34,39,7.63,73
1883910909,RCS652,47,43,7.63,90
1883910909,RCS653,44,42,7.63,86
1883910909,RCS654,46,43,7.63,89
1883910909,ROE072,25,35,7.5,60
1883910909,RCS071,25,54,7.5,79
1883910909,RCS078,26,42,7.5,68
1883910909,RCS701,24,45,7.5,69
1883910909,RCS702,22,37,7.5,59
1883910909,RCS751,45,43,7.5,88
1883910909,RCS752,37,43,7.5,80
1883910909,RCS753,78,0,7.5,78
1883910909,RCS754,169,0,7.5,169
1883910910,ROE037,22,38,7.08,60
1883910910,RAS302,16,42,7.08,58
1883910910,REC301,19,41,7.08,60
1883910910,RCS301,13,46,7.08,59
1883910910,RCS302,19,50,7.08,69
1883910910,RCS305,18,45,7.08,63
1883910910,REC351,43,45,7.08,88
1883910910,RCS351,38,44,7.08,82
1883910910,RCS352,42,43,7.08,85
1883910910,RCS355,40,44,7.08,84
1883910910,RAS401,14,22,5.83,36
1883910910,RVE401,27,40,5.83,67
1883910910,REC405,20,35,5.83,55
1883910910,RCS401,13,50,5.83,63
1883910910,RCS402,15,39,5.83,54
1883910910,RCS403,19,44,5.83,63
1883910910,RCS451,35,41,5.83,76
1883910910,RCS452,39,40,5.83,79
1883910910,RCS453,40,42,5.83,82
1883910910,RCS454,41,42,5.83,83
1883910910,RAS501,29,23,5.83,52
1883910910,RUC501,22,45,5.83,67
1883910910,RCS501,23,38,5.83,61
1883910910,RCS502,8,25,5.83,33
1883910910,RCS503,26,39,5.83,65
1883910910,RCS052,26,33,5.83,59
1883910910,RCS551,44,44,5.83,88
1883910910,RCS552,30,30,5.83,60
1883910910,RCS553,48,48,5.83,96
1883910910,RCS554,43,40,5.83,83
1883910910,RAS601,30,44,7.42,74
1883910910,RAS602,30,44,7.42,74
1883910910,RCS601,14,33,7.42,47
1883910910,RCS602,29,43,7.42,72
1883910910,RCS603,28,43,7.42,71
1883910910,RCS061,17,35,7.42,52
1883910910,RCS651,30,38,7.42,68
1883910910,RCS652,49,44,7.42,93
1883910910,RCS653,46,43,7.42,89
1883910910,RCS654,45,43,7.42,88
1883910910,ROE072,23,35,7.38,58
1883910910,RCS071,23,39,7.38,62
1883910910,RCS078,27,40,7.38,67
1883910910,RCS701,22,48,7.38,70
1883910910,RCS702,26,21,7.38,47
1883910910,RCS751,45,43,7.38,88
1883910910,RCS752,43,43,7.38,86
1883910910,RCS753,88,0,7.38,88
1883910910,RCS754,178,0,7.38,178
1883910911,ROE037,21,31,7.13,52
1883910911,RAS302,17,28,7.13,45
1883910911,REC301,22,30,7.13,52
1883910911,RCS301,15,46,7.13,61
1883910911,RCS302,21,51,7.13,72
1883910911,RCS305,23,56,7.13,79
1883910911,REC351,45,45,7.13,90
1883910911,RCS351,41,46,7.13,87
1883910911,RCS352,42,41,7.13,83
1883910911,RCS355,44,43,7.13,87
1883910911,RAS401,22,36,5.96,58
1883910911,RVE401,26,32,5.96,58
1883910911,REC405,19,30,5.96,49
1883910911,RCS401,28,38,5.96,66
1883910911,RCS402,12,30,5.96,42
1883910911,RCS403,19,21,5.96,40
1883910911,RCS451,48,40,5.96,88
1883910911,RCS452,48,41,5.96,89
1883910911,RCS453,40,41,5.96,81
1883910911,RCS454,49,49,5.96,98
1883910911,RAS501,28,38,6.46,66
1883910911,RUC501,19,41,6.46,60
1883910911,RCS501,24,53,6.46,77
1883910911,RCS502,8,25,6.46,33
1883910911,RCS503,25,35,6.46,60
1883910911,RCS052,28,44,6.46,72
1883910911,RCS551,44,44,6.46,88
1883910911,RCS552,30,33,6.46,63
1883910911,RCS553,47,47,6.46,94
1883910911,RCS554,46,45,6.46,91
1883910911,RAS601,26,44,7.79,70
1883910911,RAS602,28,46,7.79,74
1883910911,RCS601,18,39,7.79,57
1883910911,RCS602,29,46,7.79,75
1883910911,RCS603,29,46,7.79,75
1883910911,RCS061,23,42,7.79,65
1883910911,RCS651,30,39,7.79,69
1883910911,RCS652,49,45,7.79,94
1883910911,RCS653,46,44,7.79,90
1883910911,RCS654,46,44,7.79,90
1883910911,ROE072,23,32,7.17,55
1883910911,RCS071,25,34,7.17,59
1883910911,RCS078,26,39,7.17,65
1883910911,RCS701,22,36,7.17,58
1883910911,RCS702,22,38,7.17,60
1883910911,RCS751,45,43,7.17,88
1883910911,RCS752,37,44,7.17,81
1883910911,RCS753,85,0,7.17,85
1883910911,RCS754,175,0,7.17,175
1883910912,ROE037,20,32,6.04,52
1883910912,RAS302,17,24,6.04,41
1883910912,REC301,19,39,6.04,58
1883910912,RCS301,10,39,6.04,49
1883910912,RCS302,16,51,6.04,67
1883910912,RCS305,20,26,6.04,46
1883910912,REC351,41,45,6.04,86
1883910912,RCS351,39,44,6.04,83
1883910912,RCS352,38,40,6.04,78
1883910912,RCS355,43,42,6.04,85
1883910912,RAS401,16,22,5.08,38
1883910912,RVE401,25,22,5.08,47
1883910912,REC405,15,34,5.08,49
1883910912,RCS401,19,43,5.08,62
1883910912,RCS402,14,26,5.08,40
1883910912,RCS403,14,44,5.08,58
1883910912,RCS451,39,41,5.08,80
1883910912,RCS452,43,42,5.08,85
1883910912,RCS453,39,40,5.08,79
1883910912,RCS454,44,45,5.08,89
1883910912,RAS501,25,42,5.96,67
1883910912,RUC501,20,51,5.96,71
1883910912,RCS501,21,47,5.96,68
1883910912,RCS502,5,34,5.96,39
1883910912,RCS503,24,23,5.96,47
1883910912,RCS052,22,44,5.96,66
1883910912,RCS551,41,41,5.96,82
1883910912,RCS552,30,30,5.96,60
1883910912,RCS553,46,46,5.96,92
1883910912,RCS554,32,39,5.96,71
1883910912,RAS601,26,40,7.17,66
1883910912,RAS602,26,40,7.17,66
1883910912,RCS601,20,36,7.17,56
1883910912,RCS602,28,42,7.17,70
1883910912,RCS603,26,40,7.17,66
1883910912,RCS061,20,36,7.17,56
1883910912,RCS651,30,38,7.17,68
1883910912,RCS652,47,43,7.17,90
1883910912,RCS653,42,42,7.17,84
1883910912,RCS654,45,43,7.17,88
1883910912,ROE072,24,35,7.42,59
1883910912,RCS071,22,25,7.42,47
1883910912,RCS078,24,46,7.42,70
1883910912,RCS701,27,48,7.42,75
1883910912,RCS702,26,28,7.42,54
1883910912,RCS751,47,47,7.42,94
1883910912,RCS752,43,47,7.42,90
1883910912,RCS753,73,0,7.42,73
1883910912,RCS754,166,0,7.42,166
1683910026,RAS101,24,35,6.67,59
1683910026,REC101,19,47,6.67,66
1683910026,RAS103,19,25,6.67,44
1683910026,RAS104,20,46,6.67,66
1683910026,REE101,20,51,6.67,71
1683910026,RAS151,41,44,6.67,85
1683910026,REE151,41,45,6.67,86
1683910026,RAS154,45,43,6.67,88
1683910026,RME152,26,31,6.67,57
1683910026,RAS201,18,29,6.75,47
1683910026,RME201,17,48,6.75,65
1683910026,RAS203,15,38,6.75,53
1683910026,RCS201,17,46,6.75,63
1683910026,RAS202,18,42,6.75,60
1683910026,RAS252,34,46,6.75,80
1683910026,RME251,36,39,6.75,75
1683910026,RCS251,32,42,6.75,74
1683910026,RCE251,39,36,6.75,75
1683910026,RAS301,18,7,5.46,25
1683910026,RVE301,24,37,5.46,61
1683910026,ROE040,14,0,0.0,14
1683910026,RAS402,0,0,0.0,0
1683910026,ROE037,21,16,5.5,37
1683910026,RAS302,17,52,5.5,69
1683910026,REC301,15,1,5.5,16
1683910026,RCS301,17,64,5.5,81
1683910026,RCS302,20,43,5.5,63
1683910026,RCS305,23,38,5.5,61
1683910026,REC351,38,41,5.5,79
1683910026,RCS351,45,45,5.5,90
1683910026,RCS352,37,39,5.5,76
1683910026,RCS355,45,43,5.5,88
1683910026,RAS401,10,4,4.0,14
1683910026,RVE401,23,24,4.0,47
1683910026,REC405,14,25,4.0,39
1683910026,RCS401,12,12,4.0,24
1683910026,RCS402,13,48,4.0,61
1683910026,RCS403,15,51,4.0,66
1683910026,RCS451,32,40,4.0,72
1683910026,RCS452,34,38,4.0,72
1683910026,RCS453,38,37,4.0,75
1683910026,RCS454,35,40,4.0,75
1683910026,RAS501,7,0,1.21,7
1683910026,RUC501,12,0,1.21,12
1683910026,RCS501,22,0,1.21,22
1683910026,RCS502,0,0,1.21,0
1683910026,RCS503,22,0,1.21,22
1683910026,RCS052,22,0,1.21,22
1683910026,RCS551,38,30,1.21,68
1683910026,RCS552,30,30,1.21,60
1683910026,RCS553,40,30,1.21,70
1683910026,RCS554,34,31,1.21,65
